ábêcê|ˌ a - b ˌ e - s ' e
apropósito|a - p r o - p ' O - z i - t u
balanta|b a - l ' a~ - t a
balão|b a - l ' a~ w
balãosonda|b a - l ˌ a~ w - s ' o~ - d a
balar|b a - l ' a r
balázio|b a - l ' a - z j u
balba|b ' a w - b a
balbo|b ' a w - b u
balboa|b a w - b ' o - a
balbuciado|b a w - b u - s i - ' a - d u
balé|b a - l ' E
baleação|b a - l e - a - s ' a~ w
baleado|b a - l i - ' a - d u
balido|b a - l ' i - d u
banda|b ' a~ - d a
bandalheira|b a~ - d a - L ' e j - r a
bandalho|b a~ - d ' a - L u
bandulho|b a~ - d ' u - L u
banga|b ' a~ - g a
bango|b ' a~ - g u
bango|b ' a~ - g u
bangue|b a~ - g ' i
bangué|b a~ - g ' E
banguê|b a~ - g ' e
banguela|b a~ - g ' E - l a
banha|b ' a~ - J a
banhado|b a~ - J ' a - d u
banhar|b a~ - J ' a r
banheira|b a~ - J ' e j - r a
banheiro|b a~ - J ' e j - r u
banhista|b a~ - J ' i S - t a
banho|b ' a~ - J u
banhomaria|b ˌ a~ - J u - m a - r ' i - a
banta|b ' a~ - t a
banto|b ' a~ - t u
banyamulenge|b a~ - n i - a~ - m u - l ' e~ - Z i
banyamulenge|b a~ - n i - a~ - m u - l ' e~ - Z i
banza|b ' a~ - z a
banzado|b a~ - z ' a - d u
banzão|b a~ - z ' a~ w
baque|b ' a - k i
baqueado|b a - k i - ' a - d u
baquear|b a - k i - ' a r
baquelite|b a - k e - l ' i - tS i
baqueta|b a - k ' e - t a
baquetar|b a - k e - t ' a r
baquicamente|b a - k i - k a~ - m ' e~ - tS i
báquico|b ' a - k i - k u
bar|b ' a r
baraça|b a - r ' a - s a
baratamente|b a - r a - t a~ - m ' e~ - tS i
baratar|b a - r a - t ' a r
barbar|b a R - b ' a r
bárbara|b ' a R - b a - r a
barbaramente|b a R - b a - r a~ - m ' e~ - tS i
barbaridade|b a R - b a - r i - d ' a - dZ i
barbárie|b a R - b ' a - r i
barbarismo|b a R - b a - r ' i Z - m u
bárbaro|b ' a R - b a - r u
barbatana|b a R - b a - t ' a~ - n a
barbatar|b a R - b a - t ' a r
barbato|b a R - b ' a - t u
barbear|b a R - b i - ' a r
barbearia|b a R - b e - a - r ' i - a
barbeiro|b a R - b ' e j - r u
barbeito|b a R - b ' e j - t u
barbela|b a R - b ' E - l a
bardar|b a R - d ' a r
bardo|b ' a R - d u
barga|b ' a R - g a
barganha|b a R - g ' a~ - J a
barganhar|b a R - g a~ - J ' a r
baril|b a - r ' i w
barraca|b a - R ' a - k a
barracão|b a - R a - k ' a~ w
barraco|b a - R ' a - k u
barracuda|b a - R a - k ' u - d a
barrado|b a - R ' a - d u
barragem|b a - R ' a - Z e~ j
barral|b a - R ' a w
barramento|b a - R a~ - m ' e~ - t u
barranca|b a - R ' a~ - k a
barranco|b a - R ' a~ - k u
barranha|b a - R ' a~ - J a
barranhão|b a - R a~ - J ' a~ w
barranhar|b a - R a~ - J ' a r
barrigudo|b a - R i - g ' u - d u
barril|b a - R ' i w
barrinha|b a - R ' i~ - J a
barulho|b a - r ' u - L u
basal|b a - z ' a w
basáltico|b a - z ' a w - tS i - k u
basalto|b a - z ' a w - t u
basse|b ' a - s i
basta|b ' a S - t a
bastamente|b a S - t a~ - m ' e~ - tS i
bastante|b a S - t ' a~ - tS i
bastantemente|b a S - t a~ - t e~ - m ' e~ - tS i
bastos|b ' a S - t u S
bata|b ' a - t a
batalha|b a - t ' a - L a
batalhado|b a - t a - L ' a - d u
batatal|b a - t a - t ' a w
batateira|b a - t a - t ' e j - r a
batateiro|b a - t a - t ' e j - r u
batatinha|b a - t a - tS ' i~ - J a
batávico|b a - t ' a - v i - k u
bate|b ' a - tS i
bateboca|b ˌ a - tS i - b ' o - k a
batechapa|b ˌ a - tS i - S ' a - p a
batechapas|b ˌ a - tS i - S ' a - p a S
batuta|b a - t ' u - t a
baú|b a - ' u
baudelairiano|b o - d e - l a j - r i - ' a~ - n u
baunilha|b a~ w - n ' i - L a
bauxite|b a w - S ' i - tS i
bávara|b ' a - v a - r a
beato|b i - ' a - t u
bêbada|b ' e - b a - d a
bêbado|b ' e - b a - d u
bebas|b ' e - b a S
bebê|b e - b ' e
bebé|b E - b ' E
bebéproveta|b E - b ˌ E - p r o - v ' e - t a
bebêproveta|b e - b ˌ e - p r o - v ' e - t a
bêbeda|b ' e - b e - d a
bebedamente|b e - b e - d a~ - m ' e~ - tS i
beça|b ' E - s a
beca|b ' E - k a
bechamel|b e - S a~ - m ' E w
beira|b ' e j - r a
beirã|b e j - r ' a~
beiramar|b ˌ e j - r a - m ' a r
beirario|b ˌ e j - r a - R ' i - u
beirada|b e j - r ' a - d a
beirado|b e j - r ' a - d u
beiral|b e j - r ' a w
beirão|b e j - r ' a~ w
beirar|b e j - r ' a r
beirense|b e j - r ' e~ - s i
beirinha|b e j - r ' i~ - J a
bejense|b e - Z ' e~ - s i
bel|b ' E w
belisário|b e - l i - z ' a - r j u
bemmequer|b ˌ e~ j - m i - k ' E r
bemparecido|b ˌ e~ j - p a - r e - s ' i - d u
bemquerer|b ˌ e~ j - k e - r ' e r
bemvindo|b ˌ e~ j - v ' i~ - d u
bemvisto|b ˌ e~ j - v ' i S - t u
bemba|b ' e~ - b a
bemol|b e~ - m ' O w
benaventense|b e~ - n a - v e~ - t ' e~ - s i
bênção|b ' e~ - s a~ w
bendito|b e~ - dZ ' i - t u
bendizer|b e~ - dZ i - z ' e r
benévolo|b e~ - n ' E - v o - l u
benfazejo|b e~ - f a - z ' e - Z u
benzoico|b e~ - z ' O j - k u
benzol|b e~ - z ' O w
benzopireno|b e~ - z o - p i - r ' e~ - n u
beque|b ' E - k i
bera|b ' E - r a
berbequim|b e R - b e - k ' i~
berbere|b e R - b ' E - r i
berbicacho|b e R - b i - k ' a - S u
berbigão|b e R - b i - g ' a~ w
berça|b ' e r - s a
berçário|b e r - s ' a - r j u
berrar|b e - R ' a r
berraria|b e - R a - r ' i - a
betão|b e - t ' a~ w
betar|b e - t ' a r
beterraba|b e - t e - R ' a - b a
betesga|b e - t ' e Z - g a
bética|b ' E - tS i - k a
bético|b ' E - tS i - k u
betinho|b E - tS ' i~ - J u
beto|b ' E - t u
betonado|b e - t o~ - n ' a - d u
betonagem|b e - t o~ - n ' a - Z e~ j
betonar|b e - t o~ - n ' a r
betoneira|b e - t o~ - n ' e j - r a
biboca|b i - b ' o - k a
bica|b ' i - k a
bicaço|b i - k ' a - s u
bicada|b i - k ' a - d a
bicado|b i - k ' a - d u
bical|b i - k ' a w
bicalado|b i - k a - l ' a - d u
bicuda|b i - k ' u - d a
bicudo|b i - k ' u - d u
bida|b ' i - d a
bidão|b i - d ' a~ w
bidê|b i - d ' e
bidé|b i - d ' E
bidentado|b i - d e~ - t ' a - d u
bidente|b i - d ' e~ - tS i
bidestilado|b i - d e S - tS i - l ' a - d u
bidexteridade|b i - d e S - t e - r i - d ' a - dZ i
bidigitado|b i - dZ i - Z i - t ' a - d u
bidimensional|b i - dZ i~ - m e~ - s j o~ - n ' a w
bidino|b i - dZ ' i~ - n u
bidirecional|b i - dZ i - r e - s j o~ - n ' a w
biela|b j ' E - l a
bielorrussa|b j e - l o - R ' u - s a
bielorrusso|b j e - l o - R ' u - s u
bienal|b j e~ - n ' a w
bienalmente|b j e~ - n a w - m ' e~ - tS i
biene|b i - ' e~ - n i
bilionário|b i - l j o~ - n ' a - r j u
biliosa|b i - l j ' O - z a
bilioso|b i - l j ' o - z u
bílis|b ' i - l i S
biliteral|b i - l i - t e - r ' a w
bilocação|b i - l o - k a - s ' a~ w
bilontra|b i - l ' o~ - t r a
biloto|b i - l ' O - t u
bilrar|b i w - R ' a r
bilreiro|b i w - R ' e j - r u
bilro|b ' i w - R u
biltre|b ' i w - t r i
bimaculado|b i - m a - k u - l ' a - d u
bimarginado|b i - m a R - Z i~ - n ' a - d u
bimba|b ' i~ - b a
bimbalhada|b i~ - b a - L ' a - d a
bimbalhar|b i~ - b a - L ' a r
bimbar|b i~ - b ' a r
bimbo|b ' i~ - b u
bime|b i - m i
bimensal|b i~ - m e~ - s ' a w
biosfera|b j o S - f ' E - r a
biota|b j ' O - t a
biselado|b i - z e - l ' a - d u
biselar|b i - z e - l ' a r
bismuto|b i Z - m ' u - t u
bisnaga|b i Z - n ' a - g a
bisnagar|b i Z - n a - g ' a r
bisneto|b i Z - n ' E - t u
bisonhamente|b i - z u~ - J a~ - m ' e~ - tS i
bisonho|b i - z ' u~ - J u
bisonte|b i - z ' o~ - tS i
bloqueante|b l o - k i - ' a~ - tS i
bloquear|b l o - k i - ' a r
bloqueio|b l o - k ' e j - u
blusa|b l ' u - z a
blusão|b l u - z ' a~ w
boa|b ' o - a
boafé|b ˌ o - a - f ' E
boanoite|b ˌ o - a - n ' o j - tS i
boanova|b ˌ o - a - n ' O - v a
boatarde|b ˌ o - a - t ' a R - dZ i
boal|b o - ' a w
boamente|b o - a~ - m ' e~ - tS i
boasfestas|b ˌ o - a S - f ' E S - t a S
boasvindas|b ˌ o - a Z - v ' i~ - d a S
boatar|b o - a - t ' a r
boicote|b o j - k ' O - tS i
boieira|b o j - ' e j - r a
boieiro|b o j - ' e j - r u
boieiro|b o j - ' e j - r u
boina|b ' o~ j - n a
bojador|b o - Z a - d ' o r
bojar|b o - Z ' a r
bojarda|b o - Z ' a R - d a
botim|b o - tS ' i~
botina|b o - tS ' i~ - n a
boto|b ' o - t u
botoeira|b o - t w ' e j - r a
botsuana|b o - t ə - s u - ' a~ - n a
brônquico|b r ' o~ - k i - k u
brônquio|b r ' o~ - k j u
cabacinha|k a - b a - s ' i~ - J a
cabaço|k a - b ' a - s u
cabaia|k a - b ' a j - a
cadelo|k a - d ' E - l u
cadelo|k a - d ' e - l u
calhamaço|k a - L a~ - m ' a - s u
calhambeque|k a - L a~ - b ' E - k i
campesina|k a~ - p e - z ' i~ - n a
campesinato|k a~ - p e - z i~ - n ' a - t u
cantábrico|k a~ - t ' a - b r i - k u
cantábrio|k a~ - t ' a - b r j u
cantada|k a~ - t ' a - d a
cantadeira|k a~ - t a - d ' e j - r a
cantador|k a~ - t a - d ' o r
caranguejeira|k a - r a~ - g e - Z ' e j - r a
caranguejo|k a - r a~ - g ' e j - Z u
caranguejola|k a - r a~ - g e - Z ' O - l a
carreira|k a - R ' e j - r a
carreiro|k a - R ' e j - r u
carreta|k a - R ' e - t a
carretar|k a - R e - t ' a r
carreteiro|k a - R e - t ' e j - r u
carretel|k a - R e - t ' E w
catapultar|k a - t a - p u w - t ' a r
catar|k a - t ' a r
catarata|k a - t a - r ' a - t a
catarina|k a - t a - r ' i~ - n a
catarino|k a - t a - r ' i~ - n u
celestialmente|s e - l e S - tS i - a w - m ' e~ - tS i
celestina|s e - l e S - tS ' i~ - n a
celestino|s e - l e S - tS ' i~ - n u
celeuma|s e - l ' e~ w - m a
celeumar|s e - l e~ w - m ' a r
chafurdar|S a - f u R - d ' a r
chafurdice|S a - f u R - dZ ' i - s i
chafurdo|S a - f ' u R - d u
chaga|S ' a - g a
chagar|S a - g ' a r
chagrim|S a - g r ' i~
chai|S ' a j
chaimite|S a~ j - m ' i - tS i
chalaça|S a - l ' a - s a
chalaçar|S a - l a - s ' a r
chalacear|S a - l a - s i - ' a r
chalana|S a - l ' a~ - n a
chalandra|S a - l ' a~ - d r a
chispe|S ' i S - p i
chiste|S ' i S - tS i
chita|S ' i - t a
chiu|S ' i - u
choça|S ' O - s a
cimenteiro|s i~ - m e~ - t ' e j - r u
cimento|s i~ - m ' e~ - t u
cimitarra|s i~ - m i - t ' a - R a
cimo|s ' i~ - m u
cinca|s ' i~ - k a
claraboia|k l a - r a - b ' O j - a
claramente|k l a - r a~ - m ' e~ - tS i
clarão|k l a - r ' a~ w
clarear|k l a - r i - ' a r
clareira|k l a - r ' e j - r a
cobrável|k o - b r ' a - v e w
cobre|k ' O - b r i
cobrear|k o - b r i - ' a r
cobreira|k o - b r ' e j - r a
cobrição|k o - b r i - s ' a~ w
colaboracionista|k o - l a - b o - r a - s j o~ - n ' i S - t a
colaborador|k o - l a - b o - r a - d ' o r
colaboradora|k o - l a - b o - r a - d ' o - r a
colaborar|k o - l a - b o - r ' a r
combativamente|k o~ - b a - tS i - v a~ - m ' e~ - tS i
combatividade|k o~ - b a - tS i - v i - d ' a - dZ i
combativo|k o~ - b a - tS ' i - v u
compenetração|k o~ - p e~ - n e - t r a - s ' a~ w
compenetradamente|k o~ - p e~ - n e - t r a - d a~ - m ' e~ - tS i
compenetrado|k o~ - p e~ - n e - t r ' a - d u
compenetrar|k o~ - p e~ - n e - t r ' a r
conceito|k o~ - s ' e j - t u
conceituado|k o~ - s e j - t u - ' a - d u
conceitual|k o~ - s e j - t u - ' a w
confraternizar|k o~ - f r a - t e R - n i - z ' a r
confrontação|k o~ - f r o~ - t a - s ' a~ w
construtivismo|k o~ S - t r u - tS i - v ' i Z - m u
construtivista|k o~ S - t r u - tS i - v ' i S - t a
contraferro|k o~ - t r a - f ' E - R u
contrafigura|k o~ - t r a - f i - g ' u - r a
contrafila|k o~ - t r a - f ' i - l a
contrafileira|k o~ - t r a - f i - l ' e j - r a
contrafio|k o~ - t r a - f ' i - u
contrafixa|k o~ - t r a - f ' i k - s a
convenientemente|k o~ - v e~ - n j e~ - t e~ - m ' e~ - tS i
convénio|k o~ - v ' e~ - n j u
convento|k o~ - v ' e~ - t u
conventual|k o~ - v e~ - t u - ' a w
conventualmente|k o~ - v e~ - t u - a w - m ' e~ - tS i
convergência|k o~ - v e R - Z ' e~ - s j a
corporativismo|k o r - p o - r a - tS i - v ' i Z - m u
corporativista|k o r - p o - r a - tS i - v ' i S - t a
corporativo|k o r - p o - r a - tS ' i - v u
corporeidade|k o r - p o - r e j - d ' a - dZ i
cotrim|k o - t r ' i~
cotrino|k o - t r ' i~ - n u
coturno|k o - t ' u R - n u
cotutela|k o - t u - t ' E - l a
cotutor|k o - t u - t ' o r
criticista|k r i - tS i - s ' i S - t a
crítico|k r ' i - tS i - k u
criva|k r ' i - v a
crivado|k r i - v ' a - d u
crivar|k r i - v ' a r
crível|k r ' i - v e w
custeamento|k u S - t e - a~ - m ' e~ - t u
custear|k u S - tS i - ' a r
custeio|k u S - t ' e j - u
custo|k ' u S - t u
decomposição|d e - k o~ - p o - z i - s ' a~ w
décor|d e - k ' O r
decoração|d e - k o - r a - s ' a~ w
decorado|d e - k o - r ' a - d u
decorador|d e - k o - r a - d ' o r
decoradora|d e - k o - r a - d ' o - r a
decorar|d e - k o - r ' a r
delirar|d e - l i - r ' a r
delírio|d e - l ' i - r j u
delito|d e - l ' i - t u
delituoso|d e - l i - t w ' o - z u
derivação|d e - r i - v a - s ' a~ w
derivada|d e - r i - v ' a - d a
derivado|d e - r i - v ' a - d u
desagradavelmente|d e - z a - g r a - d a - v e w - m ' e~ - tS i
desagradecer|d e - z a - g r a - d e - s ' e r
desagradecido|d e - z a - g r a - d e - s ' i - d u
desagradecimento|d e - z a - g r a - d e - s i~ - m ' e~ - t u
desarcado|d e - z a r - k ' a - d u
desarcar|d e - z a r - k ' a r
desarear|d e - z a - r i - ' a r
desbrioso|d e z - b r j ' o - z u
desbrochar|d e z - b r o - S ' a r
desbulha|d e z - b ' u - L a
desbulhar|d e z - b u - L ' a r
desbunda|d e Z - b ' u~ - d a
descomparticipar|d e s - k o~ - p a r - tS i - s i - p ' a r
descompassadamente|d e S - k o~ - p a - s a - d a~ - m ' e~ - tS i
descompassado|d e S - k o~ - p a - s ' a - d u
descristianizar|d e s - k r i S - tS i - a~ - n i - z ' a r
descritivo|d e S - k r i - tS ' i - v u
descrito|d e S - k r ' i - t u
descritor|d e S - k r i - t ' o r
desencantar|d e - z e~ - k a~ - t ' a r
desencanto|d e - z e~ - k ' a~ - t u
desencapelar|d e - z e~ - k a - p e - l ' a r
desencapotar|d e - z e~ - k a - p o - t ' a r
desenterrado|d e - z e~ - t e - R ' a - d u
desenterramento|d e - z e~ - t e - R a~ - m ' e~ - t u
desenterrar|d e - z e~ - t e - R ' a r
desenterro|d e - z e~ - t ' e - R u
desfrute|d e S - f r ' u - tS i
desfruto|d e s - f r ' u - t u
desfundar|d e s - f u~ - d ' a r
desgabar|d e z - g a - b ' a r
desleixar|d e Z - l e j - S ' a r
desleixo|d e Z - l ' e j - S u
deslembrado|d e z - l e~ - b r ' a - d u
deslembrança|d e z - l e~ - b r ' a~ - s a
desnaturalização|d e z - n a - t u - r a - l i - z a - s ' a~ w
desnaturalizar|d e z - n a - t u - r a - l i - z ' a r
desnaturar|d e Z - n a - t u - r ' a r
desnavegável|d e z - n a - v e - g ' a - v e w
desnecessariamente|d e Z - n e - s e - s a - r i - a~ - m ' e~ - tS i
desnecessário|d e Z - n e - s e - s ' a - r j u
desperceber|d e S - p e r - s e - b ' e r
despercebidamente|d e S - p e r - s e - b i - d a~ - m ' e~ - tS i
despercebido|d e S - p e r - s e - b ' i - d u
desperdiçada|d e S - p e R - dZ i - s ' a - d a
desperdiçadamente|d e S - p e R - dZ i - s a - d a~ - m ' e~ - tS i
desquitação|d e s - k i - t a - s ' a~ w
desquitar|d e s - k i - t ' a r
desquite|d e s - k ' i - tS i
desrama|d e z - R ' a~ - m a
desratar|d e z - R a - t ' a r
desvairado|d e Z - v a j - r ' a - d u
desvairar|d e Z - v a j - r ' a r
desvairo|d e Z - v ' a j - r u
desvalado|d e z - v a - l ' a - d u
desvaler|d e Z - v a - l ' e r
devotado|d e - v o - t ' a - d u
devotamente|d e - v O - t a~ - m ' e~ - tS i
devotar|d e - v o - t ' a r
devoto|d e - v ' O - t u
dexteridade|d e S - t e - r i - d ' a - dZ i
dextra|d ' e S - t r a
dextrímana|d e S - t r ' i~ - m a~ - n a
dextrímano|d e S - t r ' i~ - m a~ - n u
difamador|dZ i - f a~ - m a - d ' o r
difamante|dZ i - f a~ - m ' a~ - tS i
difamar|dZ i - f a~ - m ' a r
difamatório|dZ i - f a~ - m a - t ' O - r j u
diferença|dZ i - f e - r ' e~ - s a
dinossáurio|dZ i~ - n o - s ' a w - r j u
dinossauro|dZ i~ - n o - s ' a w - r u
dinumeração|dZ i - n u~ - m e - r a - s ' a~ w
dinumerar|dZ i - n u~ - m e - r ' a r
diocesana|dZ j o - s e - z ' a~ - n a
diocesano|dZ j o - s e - z ' a~ - n u
diocese|dZ j o - s ' E - z i
dioctaedro|dZ i - O - k ə - t a - ' E - d r u
dióencarcerada|i ̃ - k a r - s e - r ' a - d a
encarcerado|i ̃ - k a r - s e - r ' a - d u
encarceramento|i ̃ - k a r - s e - r a~ - m ' e~ - t u
encarcerar|i ̃ - k a r - s e - r ' a r
encardido|i ̃ - k a R - dZ ' i - d u
encardir|i ̃ - k a R - dZ ' i r
encarecer|i ̃ - k a - r e - s ' e r
estatuto|i S - t a - t ' u - t u
estau|i S - t ' a w
estável|i S - t ' a - v e w
estavelmente|i S - t a - v e w - m ' e~ - tS i
este|' E S - tS i
este|' e S - tS i
este|' i S - tS i
esteoeste|ˌ E S - tS i - o - ' E S - tS i
estear|i S - tS i - ' a r
indiferença|i ̃ - dZ i - f e - r ' e~ - s a
indiferenciação|i ̃ - dZ i - f e - r e~ - s i - a - s ' a~ w
indiferenciado|i ̃ - dZ i - f e - r e~ - s i - ' a - d u
medicação|m e - dZ i - k a - s ' a~ w
medical|m e - dZ i - k ' a w
medicamentação|m e - dZ i - k a~ - m e~ - t a - s ' a~ w
peleira|p e - l ' e j - r a
peleiro|p e - l ' e j - r u
peleja|p e - l ' e - Z a
pelejar|p e - l e - Z ' a r
peleu|p e - l ' e w
peliça|p e - l ' i - s a
pelica|p e - l ' i - k a
pelicano|p e - l i - k ' a~ - n u
pelico|p e - l ' i - k u
película|p e - l ' i - k u - l a
pelicular|p e - l i - k u - l ' a r
pelintra|p e - l ' i~ - t r a
pelintrar|p e - l i~ - t r ' a r
pelintrice|p e - l i~ - t r ' i - s i
pelo|p ' E - l u
peloso|p e - l ' o - z u
pelota|p e - l ' O - t a
pelotão|p e - l o - t ' a~ w
pelote|p e - l ' O - tS i
pelourinho|p e - l o - r ' i~ - J u
pelouro|p e - l ' o - r u
peluche|p e - l ' u - S i
pelúcia|p e - l ' u - s j a
pelúcido|p e - l ' u - s i - d u
peluda|p e - l ' u - d a
peludo|p e - l ' u - d u
pélvico|p ' E w - v i - k u
pélvis|p ' E w - v i S
pemba|p ' e~ - b a
pena|p ' e~ - n a
penacho|p e~ - n ' a - S u
penada|p e~ - n ' a - d a
penadamente|p e~ - n a - d a~ - m ' e~ - tS i
penado|p e~ - n ' a - d u
penafidelense|p e~ - n a - f i - d e - l ' e~ - s i
penal|p e~ - n ' a w
penalidade|p e~ - n a - l i - d ' a - dZ i
penalista|p e~ - n a - l ' i S - t a
penalização|p e~ - n a - l i - z a - s ' a~ w
penalizado|p e~ - n a - l i - z ' a - d u
penalizador|p e~ - n a - l i - z a - d ' o r
penalizante|p e~ - n a - l i - z ' a~ - tS i
penalizantemente|p e~ - n a - l i - z a~ - t e~ - m ' e~ - tS i
penalizar|p e~ - n a - l i - z ' a r
penalmente|p e~ - n a w - m ' e~ - tS i
penalti|p e~ - n a w - tS ' i
penalvense|p e~ - n a w - v ' e~ - s i
penar|p e~ - n ' a r
penates|p e~ - n ' a - tS i S
penca|p ' e~ - k a
pence|p ' e~ - s i
pendão|p e~ - d ' a~ w
pendência|p e~ - d ' e~ - s j a
pendente|p e~ - d ' e~ - tS i
pender|p e~ - d ' e r
pendor|p e~ - d ' o r
pendular|p e~ - d u - l ' a r
pêndulo|p ' e~ - d u - l u
pendura|p e~ - d ' u - r a
pendurada|p e~ - d u - r ' a - d a
pendurado|p e~ - d u - r ' a - d u
pendural|p e~ - d u - r ' a w
pendurar|p e~ - d u - r ' a r
penduricalho|p e~ - d u - r i - k ' a - L u
pene|p ' e~ - n i
penedia|p e~ - n e - dZ ' i - a
penedo|p e~ - n ' e - d u
peneira|p e~ - n ' e j - r a
peneirada|p e~ - n e j - r ' a - d a
peneirado|p e~ - n e j - r ' a - d u
peneirar|p e~ - n e j - r ' a r
peneirento|p e~ - n e j - r ' e~ - t u
penela|p e~ - n ' E - l a
penélope|p e~ - n ' E - l o - p i
penetra|p e~ - n ' E - t r a
penetração|p e~ - n e - t r a - s ' a~ w
penetrador|p e~ - n e - t r a - d ' o r
penetrante|p e~ - n e - t r ' a~ - tS i
penetrantemente|p e~ - n e - t r a~ - t e~ - m ' e~ - tS i
penetrar|p e~ - n e - t r ' a r
penetrável|p e~ - n e - t r ' a - v e w
penha|p ' e~ - J a
penhasco|p e~ - J ' a S - k u
penhascoso|p e~ - J a S - k ' o - z u
penhor|p e~ - J ' o r
penhora|p e~ - J ' O - r a
penhoradamente|p e~ - J o - r a - d a~ - m ' e~ - tS i
penhorado|p e~ - J o - r ' a - d u
penhorante|p e~ - J o - r ' a~ - tS i
penhorantemente|p e~ - J o - r a~ - t e~ - m ' e~ - tS i
penhorar|p e~ - J o - r ' a r
penhorável|p e~ - J o - r ' a - v e w
penhorista|p e~ - J o - r ' i S - t a
péni|p ' e~ - n i
penicar|p e~ - n i - k ' a r
penicheiro|p e~ - n i - S ' e j - r u
penichense|p e~ - n i - S ' e~ - s i
penicilina|p e~ - n i - s i - l ' i~ - n a
penico|p e~ - n ' i - k u
penina|p e~ - n ' i~ - n a
península|p e~ - n ' i~ - s u - l a
peninsular|p e~ - n i~ - s u - l ' a r
pénis|p ' e~ - n i S
penitência|p e~ - n i - t ' e~ - s j a
penitenciado|p e~ - n i - t e~ - s i - ' a - d u
penitencial|p e~ - n i - t e~ - s i - ' a w
penitenciar|p e~ - n i - t e~ - s i - ' a r
penitenciária|p e~ - n i - t e~ - s i - ' a - r j a
penitenciaria|p e~ - n i - t e~ - s i - a - r ' i - a
penitenciário|p e~ - n i - t e~ - s i - ' a - r j u
penitente|p e~ - n i - t ' e~ - tS i
penitente|p e~ - n i - t ' e~ - tS i
peno|p ' e~ - n u
penosamente|p e~ - n O - z a~ - m ' e~ - tS i
penoso|p e~ - n ' o - z u
pensadamente|p e~ - s a - d a~ - m ' e~ - tS i
pensado|p e~ - s ' a - d u
pensador|p e~ - s a - d ' o r
pensadora|p e~ - s a - d ' o - r a
pensamento|p e~ - s a~ - m ' e~ - t u
pensante|p e~ - s ' a~ - tS i
pensão|p e~ - s ' a~ w
pensar|p e~ - s ' a r
pensativamente|p e~ - s a - tS i - v a~ - m ' e~ - tS i
pensativo|p e~ - s a - tS ' i - v u
pensável|p e~ - s ' a - v e w
penseroso|p e~ - s e - r ' o - z u
pênsil|p ' e~ - s i w
pensionar|p e~ - s j o~ - n ' a r
pensionato|p e~ - s j o~ - n ' a - t u
pensionista|p e~ - s j o~ - n ' i S - t a
penso|p ' e~ - s u
pentagonal|p e~ - t a - g o~ - n ' a w
pentágono|p e~ - t ' a - g o~ - n u
pentagrama|p e~ - t a - g r ' a~ - m a
pentatlo|p e~ - t ' a - t l u
pente|p ' e~ - tS i
penteação|p e~ - t e - a - s ' a~ w
penteadela|p e~ - t e - a - d ' E - l a
penteado|p e~ - tS i - ' a - d u
pentear|p e~ - tS i - ' a r
pentecostal|p e~ - t e - k o S - t ' a w
pentecostalismo|p e~ - t e - k o S - t a - l ' i Z - m u
penugem|p e~ - n ' u - Z e~ j
penúltima|p e~ - n ' u w - tS i~ - m a
penúltimo|p e~ - n ' u w - tS i~ - m u
penumbra|p e~ - n ' u~ - b r a
penumbrar|p e~ - n u~ - b r ' a r
penumbroso|p e~ - n u~ - b r ' o - z u
penúria|p e~ - n ' u - r j a
péon|p ' E - u~
peonagem|p j o~ - n ' a - Z e~ j
peónia|p j ' u~ - n j a
pepa|p ' e - p a
pepetela|p e - p e - t ' E - l a
pepineira|p e - p i~ - n ' e j - r a
pepino|p e - p ' i~ - n u
pepita|p e - p ' i - t a
péptico|p ' E - p i - tS i - k u
péptido|p ' E - p i - tS i - d u
pequena|p e - k ' e~ - n a
pequenada|p e - k e~ - n ' a - d a
pequenez|p e - k e~ - n ' e S
pequeneza|p e - k e~ - n ' e - z a
pequenina|p e - k e~ - n ' i~ - n a
pequenino|p e - k e~ - n ' i~ - n u
pequeníssimo|p e - k e~ - n ' i - s i~ - m u
pequenita|p e - k e~ - n ' i - t a
pequenito|p e - k e~ - n ' i - t u
pequeno|p e - k ' e~ - n u
pequenoalmoço|p e - k ˌ e~ - n u - a w - m ' o - s u
pequenote|p e - k e~ - n ' O - tS i
pequerrucha|p e - k e - R ' u - S a
pequerrucho|p e - k e - R ' u - S u
pequinês|p e - k i~ - n ' e S
per|p ' e r
pera|p ' e - r a
pera|p ' e - r a
perada|p e - r ' a - d a
perafita|p e - r a - f ' i - t a
peral|p e - r ' a w
peralta|p e - r ' a w - t a
perambular|p e - r a~ - b u - l ' a r
perante|p e - r ' a~ - tS i
perca|p ' E r - k a
percal|p e r - k ' a w
percalço|p e r - k ' a w - s u
perceba|p e r - s ' e - b a
percebe|p e r - s ' e - b i
perceber|p e r - s e - b ' e r
percebido|p e r - s e - b ' i - d u
percecionar|p e r - s e - s j o~ - n ' a r
percentagem|p e r - s e~ - t ' a - Z e~ j
percentil|p e r - s e~ - tS ' i w
percentual|p e r - s e~ - t u - ' a w
percepção|p e r - s e - p ə - s ' a~ w
perceptibilidade|p e r - s e - p i - tS i - b i - l i - d ' a - dZ i
perceptível|p e r - s e - p i - tS ' i - v e w
perceptivelmente|p e r - s e - p i - tS i - v e w - m ' e~ - tS i
percetivamente|p e r - s e - tS i - v a~ - m ' e~ - tS i
percetivo|p e r - s e - tS ' i - v u
percetual|p e r - s e - t u - ' a w
perceve|p e r - s ' e - v i
percevejo|p e r - s e - v ' e - Z u
percorrer|p e r - k o - R ' e r
percurso|p e r - k ' u r - s u
percursor|p e r - k u r - s ' o r
percussão|p e r - k u - s ' a~ w
percussionista|p e r - k u - s j o~ - n ' i S - t a
percussivo|p e r - k u - s ' i - v u
percussor|p e r - k u - s ' o r
percussor|p e r - k u - s ' o r
percutir|p e r - k u - tS ' i r
percutor|p e r - k u - t ' o r
perda|p ' e R - d a
perdão|p e R - d ' a~ w
perdedor|p e R - d e - d ' o r
perdedora|p e R - d e - d ' o - r a
perder|p e R - d ' e r
perdição|p e R - dZ i - s ' a~ w
perdida|p e R - dZ ' i - d a
perdidamente|p e R - dZ i - d a~ - m ' e~ - tS i
perdido|p e R - dZ ' i - d u
perdigão|p e R - dZ i - g ' a~ w
perdigotar|p e R - dZ i - g o - t ' a r
perdigoto|p e R - dZ i - g ' o - t u
perdigueiro|p e R - dZ i - g ' e j - r u
perdiz|p e R - dZ ' i S
perdoar|p e R - d o - ' a r
perdoável|p e R - d o - ' a - v e w
perdulária|p e R - d u - l ' a - r j a
perdulariamente|p e R - d u - l a - r i - a~ - m ' e~ - tS i
perdulário|p e R - d u - l ' a - r j u
perdurabilidade|p e R - d u - r a - b i - l i - d ' a - dZ i
perdurar|p e R - d u - r ' a r
perdurável|p e R - d u - r ' a - v e w
perduravelmente|p e R - d u - r a - v e w - m ' e~ - tS i
perecer|p e - r e - s ' e r
perecimento|p e - r e - s i~ - m ' e~ - t u
perecível|p e - r e - s ' i - v e w
peregrina|p e - r e - g r ' i~ - n a
peregrinação|p e - r e - g r i~ - n a - s ' a~ w
peregrinamente|p e - r e - g r i~ - n a~ - m ' e~ - tS i
peregrinar|p e - r e - g r i~ - n ' a r
peregrino|p e - r e - g r ' i~ - n u
pereira|p e - r ' e j - r a
pereiro|p e - r ' e j - r u
peremptoriamente|p e - r e~ m - p ə - t O - r i - a~ - m ' e~ - tS i
peremptório|p e - r e~ m - p ə - t ' O - r j u
perenemente|p e - r e~ - n e~ - m ' e~ - tS i
perenidade|p e - r e~ - n i - d ' a - dZ i
perequação|p e - r e - k w a - s ' a~ w
perestroika|p e - r e S - t r ' O j - k a
perfazer|p e r - f a - z ' e r
perfecionismo|p e r - f e - s j o~ - n ' i Z - m u
perfecionista|p e r - f e - s j o~ - n ' i S - t a
perfectível|p e r - f e - k i - tS ' i - v e w
perfeição|p e r - f e j - s ' a~ w
perfeitamente|p e r - f e j - t a~ - m ' e~ - tS i
perfeito|p e r - f ' e j - t u
pérfida|p ' E r - f i - d a
perfidamente|p E r - f i - d a~ - m ' e~ - tS i
perfídia|p e r - f ' i - dZ j a
pérfido|p ' E r - f i - d u
perfil|p e r - f ' i w
perfilado|p e r - f i - l ' a - d u
perfilar|p e r - f i - l ' a r
perfilhação|p e r - f i - L a - s ' a~ w
perfilhada|p e r - f i - L ' a - d a
perfilhado|p e r - f i - L ' a - d u
perfilhar|p e r - f i - L ' a r
performativo|p e r - f o R - m a - tS ' i - v u
perfumado|p e r - f u~ - m ' a - d u
perfumar|p e r - f u~ - m ' a r
perfumaria|p e r - f u~ - m a - r ' i - a
perfume|p e r - f ' u~ - m i
perfunctoriamente|p e r - f u~ ŋ k - t O - r i - a~ - m ' e~ - tS i
perfunctório|p e r - f u~ ŋ k - t ' O - r j u
perfuração|p e r - f u - r a - s ' a~ w
perfurado|p e r - f u - r ' a - d u
perfurador|p e r - f u - r a - d ' o r
perfuradora|p e r - f u - r a - d ' o - r a
perfurante|p e r - f u - r ' a~ - tS i
perfurar|p e r - f u - r ' a r
perfusão|p e r - f u - z ' a~ w
pergaminho|p e R - g a~ - m ' i~ - J u
pérgula|p ' E R - g u - l a
pergunta|p e R - g ' u~ - t a
perguntador|p e R - g u~ - t a - d ' o r
perguntar|p e R - g u~ - t ' a r
pericárdio|p e - r i - k ' a R - dZ j u
perícia|p e - r ' i - s j a
pericial|p e - r i - s i - ' a w
periclitante|p e - r i - k l i - t ' a~ - tS i
periclitantemente|p e - r i - k l i - t a~ - t e~ - m ' e~ - tS i
periculosidade|p e - r i - k u - l o - z i - d ' a - dZ i
periélio|p e - r j ' E - l j u
periferia|p e - r i - f e - r ' i - a
perifericamente|p e - r i - f E - r i - k a~ - m ' e~ - tS i
periférico|p e - r i - f ' E - r i - k u
perífrase|p e - r ' i - f r a - z i
perifrasticamente|p e - r i - f r a S - tS i - k a~ - m ' e~ - tS i
perifrástico|p e - r i - f r ' a S - tS i - k u
setentrional|s e - t e~ - t r j o~ - n ' a w
sétimo|s ' E - tS i~ - m u
setorial|s e - t o - r i - ' a w
setúbal|s e - t ' u - b a w
setubalense|s e - t u - b a - l ' e~ - s i
seu|s ' e w
seva|s ' E - v a
sevamente|s E - v a~ - m ' e~ - tS i
sevar|s e - v ' a r
severamente|s e - v E - r a~ - m ' e~ - tS i
severense|s e - v e - r ' e~ - s i
severidade|s e - v e - r i - d ' a - dZ i
severino|s e - v e - r ' i~ - n u
severo|s e - v ' E - r u
sevícia|s e - v ' i - s j a
seviciar|s e - v i - s i - ' a r
sevilhana|s e - v i - L ' a~ - n a
sevilhano|s e - v i - L ' a~ - n u
sevo|s ' E - v u
sexagenária|s e k - s a - Z e~ - n ' a - r j a
sexagenário|s e k - s a - Z e~ - n ' a - r j u
sexagésimo|s e k - s a - Z ' E - z i~ - m u
sexénio|s E k - s ' e~ - n j u
sexismo|s e k - s ' i Z - m u
sexista|s e k - s ' i S - t a
sexo|s ' E k - s u
sexologia|s e k - s o - l o - Z ' i - a
sexológico|s e k - s o - l ' O - Z i - k u
sexólogo|s e k - s ' O - l o - g u
sexta|s ' e S - t a
sextafeira|s ˌ e S - t a - f ' e j - r a
sextante|s e S - t ' a~ - tS i
sexteto|s e S - t ' e - t u
sextilha|s e S - tS ' i - L a
sextina|s e S - tS ' i~ - n a
sexto|s ' e S - t u
sextuplicar|s e S - t u - p l i - k ' a r
sêxtuplo|s e S - t ' u - p l u
sexuado|s e k - s u - ' a - d u
sexual|s e k - s u - ' a w
sexualidade|s e k - s u - a - l i - d ' a - dZ i
sexualizar|s e k - s u - a - l i - z ' a r
sexualmente|s e k - s u - a w - m ' e~ - tS i
sezão|s e - z ' a~ w
shakespeariana|S a j - k e S - p e - r i - ' a~ - n a
shakespeariano|S a j - k e S - p e - r i - ' a~ - n u
shakespeariano|S a j - k e S - p e - r i - ' a~ - n u
sharia|S a - r ' i - a
si|s ' i
sial|s i - ' a w
siamês|s i - a~ - m ' e S
siamesa|s i - a~ - m ' e - z a
siar|s i - ' a r
siba|s ' i - b a
sibarita|s i - b a - r ' i - t a
sibaritar|s i - b a - r i - t ' a r
sibariticamente|s i - b a - r i - tS i - k a~ - m ' e~ - tS i
sibarítico|s i - b a - r ' i - tS i - k u
sibe|s ' i - b i
sibéria|s i - b ' E - r j a
siberiana|s i - b e - r i - ' a~ - n a
siberiano|s i - b e - r i - ' a~ - n u
sibila|s i - b ' i - l a
sibilação|s i - b i - l a - s ' a~ w
sibilante|s i - b i - l ' a~ - tS i
sibilantemente|s i - b i - l a~ - t e~ - m ' e~ - tS i
sibilar|s i - b i - l ' a r
sibilinamente|s i - b i - l i~ - n a~ - m ' e~ - tS i
sibilino|s i - b i - l ' i~ - n u
sibilo|s i - b ' i - l u
sic|s ' i k
sica|s ' i - k a
sicário|s i - k ' a - r j u
siciliana|s i - s i - l i - ' a~ - n a
siciliano|s i - s i - l i - ' a~ - n u
siclo|s ' i - k l u
sicómoro|s i - k ' u~ - m o - r u
sicômoro|s i - k ' u~ - m o - r u
sicrano|s i - k r ' a~ - n u
sida|s ' i - d a
sideração|s i - d e - r a - s ' a~ w
siderado|s i - d e - r ' a - d u
sideral|s i - d e - r ' a w
siderar|s i - d e - r ' a r
siderurgia|s i - d e - r u R - Z ' i - a
siderúrgico|s i - d e - r ' u R - Z i - k u
sidónio|s i - d ' u~ - n j u
sidonismo|s i - d o~ - n ' i Z - m u
sidonista|s i - d o~ - n ' i S - t a
sidra|s ' i - d r a
siena|s j ' e~ - n a
sienito|s i - e~ - n ' i - t u
sifão|s i - f ' a~ w
sífilis|s ' i - f i - l i S
sigilar|s i - Z i - l ' a r
sigilo|s i - Z ' i - l u
sigilosamente|s i - Z i - l O - z a~ - m ' e~ - tS i
sigiloso|s i - Z i - l ' o - z u
sigla|s ' i - g l a
siglar|s i - g l ' a r
sigma|s ' i - g ə ̃ - m a
signatária|s i - g ə ̃ - n a - t ' a - r j a
signatário|s i - g ə ̃ - n a - t ' a - r j u
significação|s i - g i~ - n i - f i - k a - s ' a~ w
significado|s i - g i~ - n i - f i - k ' a - d u
significante|s i - g i~ - n i - f i - k ' a~ - tS i
significar|s i - g i~ - n i - f i - k ' a r
significativamente|s i - g i~ - n i - f i - k a - tS i - v a~ - m ' e~ - tS i
significativo|s i - g i~ - n i - f i - k a - tS ' i - v u
signo|s ' i - g ə ̃ - n u
sílaba|s ' i - l a - b a
silabar|s i - l a - b ' a r
silabário|s i - l a - b ' a - r j u
silabicamente|s i - l a - b i - k a~ - m ' e~ - tS i
silábico|s i - l ' a - b i - k u
silagem|s i - l ' a - Z e~ j
silenciador|s i - l e~ - s i - a - d ' o r
silenciamento|s i - l e~ - s i - a~ - m ' e~ - t u
silenciar|s i - l e~ - s i - ' a r
silêncio|s i - l ' e~ - s j u
silenciosa|s i - l e~ - s j ' O - z a
silenciosamente|s i - l e~ - s j o - z a~ - m ' e~ - tS i
silencioso|s i - l e~ - s j ' o - z u
sileno|s i - l ' e~ - n u
silente|s i - l ' e~ - tS i
silesiano|s i - l e - z i - ' a~ - n u
sílex|s ' i - l E k s
sílfide|s ' i w - f i - dZ i
silha|s ' i - L a
silhar|s i - L ' a r
silhueta|s i - L w ' e - t a
sílica|s ' i - l i - k a
silicato|s i - l i - k ' a - t u
silício|s i - l ' i - s j u
silicioso|s i - l i - s j ' o - z u
silicone|s i - l i - k ' u~ - n i
silicose|s i - l i - k ' O - z i
silo|s ' i - l u
siloauto|s ˌ i - l o - ' a w - t u
silogismo|s i - l o - Z ' i Z - m u
silogisticamente|s i - l o - Z i S - tS i - k a~ - m ' e~ - tS i
silogístico|s i - l o - Z ' i S - tS i - k u
silte|s ' i w - tS i
silva|s ' i w - v a
silvado|s i w - v ' a - d u
silvano|s i w - v ' a~ - n u
silvar|s i w - v ' a r
silveira|s i w - v ' e j - r a
silveiral|s i w - v e j - r ' a w
silveiro|s i w - v ' e j - r u
silvestre|s i w - v ' E S - t r i
silvícola|s i w - v ' i - k o - l a
silvicultor|s i w - v i - k u w - t ' o r
silvicultura|s i w - v i - k u w - t ' u - r a
silvina|s i w - v ' i~ - n a
silvo|s ' i w - v u
sim|s ' i~
sima|s ' i~ - m a
simão|s i~ - m ' a~ w
simba|s ' i~ - b a
simbiose|s i~ - b j ' O - z i
simbioticamente|s i~ - b j O - tS i - k a~ - m ' e~ - tS i
simbiótico|s i~ - b j ' O - tS i - k u
simbólica|s i~ - b ' O - l i - k a
simbolicamente|s i~ - b O - l i - k a~ - m ' e~ - tS i
simbólico|s i~ - b ' O - l i - k u
simbolismo|s i~ - b o - l ' i Z - m u
simbolista|s i~ - b o - l ' i S - t a
simbolização|s i~ - b o - l i - z a - s ' a~ w
simbolizar|s i~ - b o - l i - z ' a r
símbolo|s ' i~ - b o - l u
simbologia|s i~ - b o - l o - Z ' i - a
simetria|s i~ - m e - t r ' i - a
simetricamente|s i~ - m E - t r i - k a~ - m ' e~ - tS i
simétrico|s i~ - m ' E - t r i - k u
simiescamente|s i~ - m j e S - k a~ - m ' e~ - tS i
simiesco|s i~ - m j ' e S - k u
similar|s i~ - m i - l ' a r
similaridade|s i~ - m i - l a - r i - d ' a - dZ i
símile|s ' i~ - m i - l i
similitude|s i~ - m i - l i - t ' u - dZ i
símio|s ' i~ - m j u
simonia|s i~ - m o~ - n ' i - a
simpatia|s i~ - p a - tS ' i - a
simpaticamente|s i~ - p a - tS i - k a~ - m ' e~ - tS i
simpático|s i~ - p ' a - tS i - k u
simpatiquíssimo|s i~ - p a - tS i - k ' i - s i~ - m u
simpatizante|s i~ - p a - tS i - z ' a~ - tS i
simpatizar|s i~ - p a - tS i - z ' a r
simples|s ' i~ - p l i S
simplesmente|s i~ - p l e Z - m ' e~ - tS i
simpleza|s i~ - p l ' e - z a
simplicidade|s i~ - p l i - s i - d ' a - dZ i
simplicissimamente|s i~ - p l i - s i - s i~ - m a~ - m ' e~ - tS i
simplicíssimo|s i~ - p l i - s ' i - s i~ - m u
simplificação|s i~ - p l i - f i - k a - s ' a~ w
simplificadamente|s i~ - p l i - f i - k a - d a~ - m ' e~ - tS i
simplificador|s i~ - p l i - f i - k a - d ' o r
simplificadora|s i~ - p l i - f i - k a - d ' o - r a
simplificar|s i~ - p l i - f i - k ' a r
simplismo|s i~ - p l ' i Z - m u
simplista|s i~ - p l ' i S - t a
simplistamente|s i~ - p l i S - t a~ - m ' e~ - tS i
simplória|s i m - p l ' O - r j a
simploriamente|s i m - p l O - r i - a~ - m ' e~ - tS i
simplório|s i~ - p l ' O - r j u
simplório|s i m - p l ' O - r j u
simpósio|s i~ - p ' O - z j u
simulação|s i~ - m u - l a - s ' a~ w
simulacro|s i~ - m u - l ' a - k r u
simuladamente|s i~ - m u - l a - d a~ - m ' e~ - tS i
simulado|s i~ - m u - l ' a - d u
simulador|s i~ - m u - l a - d ' o r
simular|s i~ - m u - l ' a r
simultaneamente|s i~ - m u w - t a~ - n e - a~ - m ' e~ - tS i
simultaneidade|s i~ - m u w - t a~ - n e j - d ' a - dZ i
simultâneo|s i~ - m u w - t ' a~ - n j u
sina|s ' i~ - n a
sinagoga|s i~ - n a - g ' O - g a
sinal|s i~ - n ' a w
sinalefa|s i~ - n a - l ' E - f a
sinaleira|s i~ - n a - l ' e j - r a
sinaleiro|s i~ - n a - l ' e j - r u
sinalética|s i~ - n a - l ' E - tS i - k a
sinalético|s i~ - n a - l ' E - tS i - k u
sinalização|s i~ - n a - l i - z a - s ' a~ w
sinalizar|s i~ - n a - l i - z ' a r
sinapse|s i~ - n ' a - p ə - s i
sinceramente|s i~ - s E - r a~ - m ' e~ - tS i
sinceridade|s i~ - s e - r i - d ' a - dZ i
sincero|s i~ - s ' E - r u
síncopa|s ' i~ - k o - p a
sincopadamente|s i~ - k o - p a - d a~ - m ' e~ - tS i
sincopado|s i~ - k o - p ' a - d u
sincopar|s i~ - k o - p ' a r
síncope|s ' i~ - k o - p i
sincreticamente|s i~ - k r E - tS i - k a~ - m ' e~ - tS i
sincrético|s i~ - k r ' E - tS i - k u
sincretismo|s i~ - k r e - tS ' i Z - m u
sincretista|s i~ - k r e - tS ' i S - t a
sincronia|s i~ - k r o~ - n ' i - a
sincronicamente|s i~ - k r u~ - n i - k a~ - m ' e~ - tS i
sincrónico|s i~ - k r ' u~ - n i - k u
sincronismo|s i~ - k r o~ - n ' i Z - m u
sincronização|s i~ - k r o~ - n i - z a - s ' a~ w
sincronizado|s i~ - k r o~ - n i - z ' a - d u
sincronizar|s i~ - k r o~ - n i - z ' a r
síncrono|s ' i~ - k r o~ - n u
sincrotrão|s i~ - k r O - t r ' a~ w
sindicação|s i~ - dZ i - k a - s ' a~ w
sindicado|s i~ - dZ i - k ' a - d u
sindical|s i~ - dZ i - k ' a w
sindicalismo|s i~ - dZ i - k a - l ' i Z - m u
sindicalista|s i~ - dZ i - k a - l ' i S - t a
sindicalista|s i~ - dZ i - k a - l ' i S - t a
sindicalização|s i~ - dZ i - k a - l i - z a - s ' a~ w
sindicalizada|s i~ - dZ i - k a - l i - z ' a - d a
sindicalizado|s i~ - dZ i - k a - l i - z ' a - d u
sindicalizar|s i~ - dZ i - k a - l i - z ' a r
sindicalmente|s i~ - dZ i - k a w - m ' e~ - tS i
sindicância|s i~ - dZ i - k ' a~ - s j a
sindicante|s i~ - dZ i - k ' a~ - tS i
sindicar|s i~ - dZ i - k ' a r
sindicato|s i~ - dZ i - k ' a - t u
síndico|s ' i~ - dZ i - k u
síndroma|s ' i~ - d r o~ - m a
síndrome|s ' i~ - d r o~ - m i
sinecura|s i~ - n e - k ' u - r a
sinédoque|s i~ - n ' E - d o - k i
sinédrio|s i~ - n ' E - d r j u
sineense|s i~ - n e - ' e~ - s i
sineira|s i~ - n ' e j - r a
sineiro|s i~ - n ' e j - r u
sinergia|s i~ - n e R - Z ' i - a
sinergicamente|s i~ - n E R - Z i - k a~ - m ' e~ - tS i
sinérgico|s i~ - n ' E R - Z i - k u
sinestesia|s i~ - n e S - t e - z ' i - a
sinestésico|s i~ - n e S - t ' E - z i - k u
sineta|s i~ - n ' e - t a
sinetar|s i~ - n e - t ' a r
sinete|s i~ - n ' e - tS i
sinfonia|s i~ - f o~ - n ' i - a
sinfonicamente|s i~ - f u~ - n i - k a~ - m ' e~ - tS i
sinfónico|s i~ - f ' u~ - n i - k u
sinfonieta|s i~ - f o~ - n j ' e - t a
sinfonista|s i~ - f o~ - n ' i S - t a
sinfonista|s i~ - f o~ - n ' i S - t a
singapurense|s i~ - g a - p u - r ' e~ - s i
singela|s i~ - Z ' E - l a
singelamente|s i~ - Z E - l a~ - m ' e~ - tS i
singeleza|s i~ - Z e - l ' e - z a
singelo|s i~ - Z ' E - l u
singrar|s i~ - g r ' a r
singular|s i~ - g u - l ' a r
singularidade|s i~ - g u - l a - r i - d ' a - dZ i
singularizar|s i~ - g u - l a - r i - z ' a r
singularmente|s i~ - g u - l a R - m ' e~ - tS i
sinhá|s i~ - J ' a
sinhô|s i~ - J ' o
sínico|s ' i~ - n i - k u
siniense|s i~ - n j ' e~ - s i
sinistra|s i~ - n ' i S - t r a
turismo|t u - r ' i Z - m u
turista|t u - r ' i S - t a
turisticamente|t u - r i S - tS i - k a~ - m ' e~ - tS i
turístico|t u - r ' i S - tS i - k u
turma|t ' u R - m a
turno|t ' u R - n u
turpilóquio|t u r - p i - l ' O - k j u
turquês|t u r - k ' e S
turquesa|t u r - k ' e - z a
turquesa|t u r - k ' e - z a
turra|t ' u - R a
turrar|t u - R ' a r
turvação|t u R - v a - s ' a~ w
turvamente|t u R - v a~ - m ' e~ - tS i
turvar|t u R - v ' a r
turvo|t ' u R - v u
tutaemeia|t ˌ u - t a - i - m ' e j - a
tutano|t u - t ' a~ - n u
tutela|t u - t ' E - l a
tutelada|t u - t e - l ' a - d a
tutelado|t u - t e - l ' a - d u
tutelar|t u - t e - l ' a r
tutor|t u - t ' o r
tutora|t u - t ' o - r a
tutorar|t u - t o - r ' a r
tutoria|t u - t o - r ' i - a
tutorial|t u - t o - r i - ' a w
tutsi|t u - t i - s ' i
tutu|t u - t ' u
u|' u
úbere|' u - b e - r i
ubérrimo|u - b ' E - R i~ - m u
ubi|u - b ' i
ubiquamente|u - b i - k w a~ - m ' e~ - tS i
ubiquidade|u - b i - k w i - d ' a - dZ i
ubíquo|u - b ' i - k w u
ucha|' u - S a
ucraniana|u - k r a~ - n i - ' a~ - n a
ucraniano|u - k r a~ - n i - ' a~ - n u
ucronia|u - k r o~ - n ' i - a
udo|' u - d u
udu|u - d ' u
ué|u - ' E
uê|u - ' e
uf|' u f
ufa|' u - f a
ufa|' u - f a
ufanamente|u - f a~ - n a~ - m ' e~ - tS i
ufanar|u - f a~ - n ' a r
ufania|u - f a~ - n ' i - a
ufano|u - f ' a~ - n u
ugandês|u - g a~ - d ' e S
ugandesa|u - g a~ - d ' e - z a
ugar|u - g ' a r
uh|' u
ui|' u - i
uigure|w i - g ' u - r i
uísque|w ' i S - k i
uivante|w i - v ' a~ - tS i
uivar|w i - v ' a r
uivo|w ' i - v u
uja|' u - Z a
úlcera|' u w - s e - r a
ulceração|u w - s e - r a - s ' a~ w
ulcerado|u w - s e - r ' a - d u
ulcerar|u w - s e - r ' a r
ulceroso|u w - s e - r ' o - z u
ulissiponense|u - l i - s i - p o~ - n ' e~ - s i
ulmeiro|u w - m ' e j - r u
ulterior|u w - t e - r j ' o r
ulteriormente|u w - t e - r j o R - m ' e~ - tS i
última|' u w - tS i~ - m a
ultimação|u w - tS i~ - m a - s ' a~ w
ultimado|u w - tS i~ - m ' a - d u
ultimamente|u w - tS i~ - m a~ - m ' e~ - tS i
ultimar|u w - tS i~ - m ' a r
últimas|' u w - tS i~ - m a S
ultimato|u w - tS i~ - m ' a - t u
último|' u w - tS i~ - m u
ultra|' u w - t r a
ultrahiperbólico|u w - t r a - i - p E R - b ' O - l i - k u
ultrahomérico|u w - t r a - o~ - m ' E - r i - k u
ultrahumano|u w - t r a - u~ - m ' a~ - n u
ultrabásico|u w - t r a - b ' a - z i - k u
ultracentrifugação|u w - t r a - s e~ - t r i - f u - g a - s ' a~ w
ultracentrifugar|u w - t r a - s e~ - t r i - f u - g ' a r
ultracompetente|u w - t r a - k o~ - p e - t ' e~ - tS i
ultraconfiança|u w - t r a - k o~ - f i - ' a~ - s a
ultracongelação|u w - t r a - k o~ - Z e - l a - s ' a~ w
ultracongelado|u w - t r a - k o~ - Z e - l ' a - d u
ultraconservador|u w - t r a - k o~ - s e R - v a - d ' o r
ultraconservadora|u w - t r a - k o~ - s e R - v a - d ' o - r a
ultracorreção|u w - t r a - k o - R e - s ' a~ w
ultracorreto|u w - t r a - k o - R ' E - t u
ultracorrigido|u w - t r a - k o - R i - Z ' i - d u
ultracurto|u w - t r a - k ' u r - t u
ultrademocrático|u w - t r a - d e~ - m o - k r ' a - tS i - k u
ultradivino|u w - t r a - dZ i - v ' i~ - n u
ultraesdrúxulo|u w - t r a - e Z - d r ' u - S u - l u
ultraetimológico|u w - t r a - e - tS i~ - m o - l ' O - Z i - k u
ultraexistência|u w - t r a - e - z i S - t ' e~ - s j a
ultraexistente|u w - t r a - e - z i S - t ' e~ - tS i
ultrafabuloso|u w - t r a - f a - b u - l ' o - z u
ultrafantástico|u w - t r a - f a~ - t ' a S - tS i - k u
ultrafiltração|u w - t r a - f i w - t r a - s ' a~ w
ultrainfernal|u w - t r a - i~ - f e R - n ' a w
ultrajado|u w - t r a - Z ' a - d u
ultrajante|u w - t r a - Z ' a~ - tS i
ultrajantemente|u w - t r a - Z a~ - t e~ - m ' e~ - tS i
ultrajar|u w - t r a - Z ' a r
ultraje|u w - t r ' a - Z i
ultrajudicial|u w - t r a - Z u - dZ i - s i - ' a w
ultraleve|u w - t r a - l ' E - v i
ultraliberal|u w - t r a - l i - b e - r ' a w
ultraliberalismo|u w - t r a - l i - b e - r a - l ' i Z - m u
ultralírico|u w - t r a - l ' i - r i - k u
ultralongo|u w - t r a - l ' o~ - g u
ultramar|u w - t r a~ - m ' a r
ultramarino|u w - t r a~ - m a - r ' i~ - n u
ultrametamórfico|u w - t r a - m e - t a~ - m ' O r - f i - k u
ultramicroscopia|u w - t r a - m i - k r o S - k o - p ' i - a
ultramicroscópico|u w - t r a - m i - k r o S - k ' O - p i - k u
ultramicroscópio|u w - t r a - m i - k r o S - k ' O - p j u
ultramilitarismo|u w - t r a - m i - l i - t a - r ' i Z - m u
ultramilitarista|u w - t r a - m i - l i - t a - r ' i S - t a
ultramodernismo|u w - t r a - m o - d e R - n ' i Z - m u
ultramodernista|u w - t r a - m o - d e R - n ' i S - t a
ultramoderno|u w - t r a~ - m o - d ' E R - n u
ultramonárquico|u w - t r a - m o~ - n ' a r - k i - k u
ultramontana|u w - t r a~ - m o~ - t ' a~ - n a
ultramontanismo|u w - t r a~ - m o~ - t a~ - n ' i Z - m u
ultramontano|u w - t r a~ - m o~ - t ' a~ - n u
ultramontano|u w - t r a~ - m o~ - t ' a~ - n u
ultramundano|u w - t r a - m u~ - d ' a~ - n u
ultranacionalista|u w - t r a - n a - s j o~ - n a - l ' i S - t a
ultranatural|u w - t r a - n a - t u - r ' a w
ultraoceânico|u w - t r a - o - s i - ' a~ - n i - k u
ultraortodoxo|u w - t r a - o r - t o - d ' O k - s u
ultraparadoxal|u w - t r a - p a - r a - d o k - s ' a w
ultrapassado|u w - t r a - p a - s ' a - d u
ultrapassagem|u w - t r a - p a - s ' a - Z e~ j
ultrapassante|u w - t r a - p a - s ' a~ - tS i
ultrapassar|u w - t r a - p a - s ' a r
ultrapassável|u w - t r a - p a - s ' a - v e w
ultrapasteurizado|u w - t r a - p a S - t e w - r i - z ' a - d u
ultraperiférico|u w - t r a - p e - r i - f ' E - r i - k u
ultrapressão|u w - t r a - p r e - s ' a~ w
ultraprovar|u w - t r a - p r o - v ' a r
ultraquímico|u w - t r a - k ' i~ - m i - k u
ultrarradical|u w - t r a - R a - dZ i - k ' a w
ultrarrápido|u w - t r a - R ' a - p i - d u
ultrarreação|u w - t r a - R e - a - s ' a~ w
ultrarreacionária|u w - t r a - R e - a - s j o~ - n ' a - r j a
ultrarreacionário|u w - t r a - R e - a - s j o~ - n ' a - r j u
ultrarrealismo|u w - t r a - R e - a - l ' i Z - m u
ultrarrealista|u w - t r a - R e - a - l ' i S - t a
ultrarrevolução|u w - t r a - R e - v o - l u - s ' a~ w
ultrarrevolucionária|u w - t r a - R e - v o - l u - s j o~ - n ' a - r j a
ultrarrevolucionário|u w - t r a - R e - v o - l u - s j o~ - n ' a - r j u
ultrarrigoroso|u w - t r a - R i - g o - r ' o - z u
ultrarromântica|u w - t r a - R o~ - m ' a~ - tS i - k a
ultrarromântico|u w - t r a - R o~ - m ' a~ - tS i - k u
ultrarromantismo|u w - t r a - R o~ - m a~ - tS ' i Z - m u
ultrarromantizar|u w - t r a - R o~ - m a~ - tS i - z ' a r
ultrarroxo|u w - t r a - R ' o - S u
ultrassecreto|u w - t r a - s e - k r ' E - t u
ultrassecular|u w - t r a - s e - k u - l ' a r
ultrassensível|u w - t r a - s e~ - s ' i - v e w
ultrassofisticado|u w - t r a - s o - f i S - tS i - k ' a - d u
ultrassolar|u w - t r a - s o - l ' a r
ultrassom|u w - t r a - s ' o~
ultrassónico|u w - t r a - s ' u~ - n i - k u
ultrassonoro|u w - t r a - s o~ - n ' O - r u
ultraterreno|u w - t r a - t e - R ' e~ - n u
ultraterrestre|u w - t r a - t e - R ' E S - t r i
ultratumular|u w - t r a - t u~ - m u - l ' a r
ultraveloz|u w - t r a - v e - l ' O S
ultravermelho|u w - t r a - v e R - m ' e - L u
ultravioleta|u w - t r a - v j o - l ' e - t a
ultravírus|u w - t r a - v ' i - r u S
ultrazodiacal|u w - t r a - z o - dZ i - a - k ' a w
ululante|u - l u - l ' a~ - tS i
ulular|u - l u - l ' a r
um|' u~
um|' u ̃
uma|' u~ - m a
umar|u ̃ - m ' a r
umbanda|u ̃ - b ' a~ - d a
umbelífera|u ̃ - b e - l ' i - f e - r a
umbelífero|u ̃ - b e - l ' i - f e - r u
umbigo|u ̃ - b ' i - g u
umbilical|u ̃ - b i - l i - k ' a w
umbral|u ̃ - b r ' a w
umbria|u ̃ - b r ' i - a
umbro|' u~ - b r u
umbundo|u ̃ - b ' u~ - d u
umbuzeiro|u ̃ - b u - z ' e j - r u
ume|' u~ - m i
úmero|' u~ - m e - r u
unamente|u ̃ - n a~ - m ' e~ - tS i
unanimar|u ̃ - n a~ - n i~ - m ' a r
unânime|u ̃ - n ' a~ - n i~ - m i
unanimemente|u ̃ - n a~ - n i~ - m e~ - m ' e~ - tS i
unanimidade|u ̃ - n a~ - n i~ - m i - d ' a - dZ i
unanimismo|u ̃ - n a~ - n i~ - m ' i Z - m u
unanimista|u ̃ - n a~ - n i~ - m ' i S - t a
unar|u ̃ - n ' a r
unção|u ̃ - s ' a~ w
ungida|u ̃ - Z ' i - d a
ungido|u ̃ - Z ' i - d u
ungir|u ̃ - Z ' i r
unguentar|u ̃ - g w e~ - t ' a r
unguento|u ̃ - g w ' e~ - t u
ungulado|u ̃ - g u - l ' a - d u
unha|' u~ - J a
unhada|u ̃ - J ' a - d a
unhão|u ̃ - J ' a~ w
unhar|u ̃ - J ' a r
união|u ̃ - n i - ' a~ w
única|' u~ - n i - k a
unicamente|u ̃ - n i - k a~ - m ' e~ - tS i
unicelular|u ̃ - n i - s e - l u - l ' a r
unicidade|u ̃ - n i - s i - d ' a - dZ i
único|' u~ - n i - k u
unicolor|u ̃ - n i - k o - l ' o r
unicórnio|u ̃ - n i - k ' O R - n j u
unidade|u ̃ - n i - d ' a - dZ i
unidamente|u ̃ - n i - d a~ - m ' e~ - tS i
unidimensional|u ̃ - n i - dZ i~ - m e~ - s j o~ - n ' a w
unidirecional|u ̃ - n i - dZ i - r e - s j o~ - n ' a w
unido|u ̃ - n ' i - d u
unificação|u ̃ - n i - f i - k a - s ' a~ w
unificado|u ̃ - n i - f i - k ' a - d u
unificador|u ̃ - n i - f i - k a - d ' o r
unificador|u ̃ - n i - f i - k a - d ' o r
unificadora|u ̃ - n i - f i - k a - d ' o - r a
unificar|u ̃ - n i - f i - k ' a r
unificável|u ̃ - n i - f i - k ' a - v e w
uniformar|u ̃ - n i - f o R - m ' a r
uniforme|u ̃ - n i - f ' O R - m i
uniformemente|u ̃ - n i - f O R - m e~ - m ' e~ - tS i
uniformidade|u ̃ - n i - f o R - m i - d ' a - dZ i
uniformização|u ̃ - n i - f o R - m i - z a - s ' a~ w
uniformizado|u ̃ - n i - f o R - m i - z ' a - d u
uniformizador|u ̃ - n i - f o R - m i - z a - d ' o r
uniformizadora|u ̃ - n i - f o R - m i - z a - d ' o - r a
uniformizar|u ̃ - n i - f o R - m i - z ' a r
unigénito|u ̃ - n i - Z ' e~ - n i - t u
unilateral|u ̃ - n i - l a - t e - r ' a w
unilateralidade|u ̃ - n i - l a - t e - r a - l i - d ' a - dZ i
unilateralismo|u ̃ - n i - l a - t e - r a - l ' i Z - m u
unilateralmente|u ̃ - n i - l a - t e - r a w - m ' e~ - tS i
uninominal|u ̃ - n i~ - n o~ - m i~ - n ' a w
unionismo|u ̃ - n j o~ - n ' i Z - m u
unionista|u ̃ - n j o~ - n ' i S - t a
unipessoal|u ̃ - n i - p e - s o - ' a w
unipessoalmente|u ̃ - n i - p e - s o - a w - m ' e~ - tS i
unipolar|u ̃ - n i - p o - l ' a r
unipolaridade|u ̃ - n i - p o - l a - r i - d ' a - dZ i
unir|u ̃ - n ' i r
unissexo|u ̃ - n i - s ' E k - s u
unissexual|u ̃ - n i - s e k - s u - ' a w
unissonamente|u ̃ - n i - s o~ - n a~ - m ' e~ - tS i
uníssono|u ̃ - n ' i - s o~ - n u
unitária|u ̃ - n i - t ' a - r j a
unitariamente|u ̃ - n i - t a - r i - a~ - m ' e~ - tS i
unitário|u ̃ - n i - t ' a - r j u
unitarismo|u ̃ - n i - t a - r ' i Z - m u
unitarista|u ̃ - n i - t a - r ' i S - t a
unitivo|u ̃ - n i - tS ' i - v u
universal|u ̃ - n i - v e r - s ' a w
universalidade|u ̃ - n i - v e r - s a - l i - d ' a - dZ i
universalismo|u ̃ - n i - v e r - s a - l ' i Z - m u
universalista|u ̃ - n i - v e r - s a - l ' i S - t a
universalização|u ̃ - n i - v e r - s a - l i - z a - s ' a~ w
universalizar|u ̃ - n i - v e r - s a - l i - z ' a r
universalizável|u ̃ - n i - v e r - s a - l i - z ' a - v e w
universalmente|u ̃ - n i - v e r - s a w - m ' e~ - tS i
universidade|u ̃ - n i - v e r - s i - d ' a - dZ i
universitária|u ̃ - n i - v e r - s i - t ' a - r j a
universitariamente|u ̃ - n i - v e r - s i - t a - r i - a~ - m ' e~ - tS i
universitário|u ̃ - n i - v e r - s i - t ' a - r j u
universitário|u ̃ - n i - v e r - s i - t ' a - r j u
universo|u ̃ - n i - v ' E r - s u
univocamente|u ̃ - n i - v o - k a~ - m ' e~ - tS i
univocidade|u ̃ - n i - v o - s i - d ' a - dZ i
unívoco|u ̃ - n ' i - v o - k u
untar|u ̃ - t ' a r
unto|' u~ - t u
untuosamente|u ̃ - t w O - z a~ - m ' e~ - tS i
untuosidade|u ̃ - t w o - z i - d ' a - dZ i
untuoso|u ̃ - t w ' o - z u
upa|' u - p a
upar|u - p ' a r
ura|' u - r a
uracilo|u - r a - s ' i - l u
uralita|u - r a - l ' i - t a
urânico|u - r ' a~ - n i - k u
urânio|u - r ' a~ - n j u
urbana|u R - b ' a~ - n a
urbanamente|u R - b a~ - n a~ - m ' e~ - tS i
urbanidade|u R - b a~ - n i - d ' a - dZ i
urbanismo|u R - b a~ - n ' i Z - m u
urbanista|u R - b a~ - n ' i S - t a
urbanisticamente|u R - b a~ - n i S - tS i - k a~ - m ' e~ - tS i
urbanístico|u R - b a~ - n ' i S - tS i - k u
urbanita|u R - b a~ - n ' i - t a
urbanização|u R - b a~ - n i - z a - s ' a~ w
urbanizado|u R - b a~ - n i - z ' a - d u
urbanizador|u R - b a~ - n i - z a - d ' o r
urbanizar|u R - b a~ - n i - z ' a r
urbano|u R - b ' a~ - n u
urbe|' u R - b i
urca|' u r - k a
urdido|u R - dZ ' i - d u
urdidura|u R - dZ i - d ' u - r a
urdir|u R - dZ ' i r
urdu|u R - d ' u
ureia|u - r ' e j - a
uremia|u - r e~ - m ' i - a
uréter|u - r ' E - t E r
uretra|u - r ' E - t r a
uretrite|u - r e - t r ' i - tS i
urgência|u R - Z ' e~ - s j a
urgente|u R - Z ' e~ - tS i
urgentemente|u R - Z e~ - t e~ - m ' e~ - tS i
urgir|u R - Z ' i r
uri|u - r ' i
úrico|' u - r i - k u
urina|u - r ' i~ - n a
urinar|u - r i~ - n ' a r
urinário|u - r i~ - n ' a - r j u
urinol|u - r i~ - n ' O w
urna|' u R - n a
uro|' u - r u
urografia|u - r o - g r a - f ' i - a
urologia|u - r o - l o - Z ' i - a
urológico|u - r o - l ' O - Z i - k u
urologista|u - r o - l o - Z ' i S - t a
urraca|u - R ' a - k a
urrar|u - R ' a r
urro|' u - R u
urso|' u r - s u
ursulina|u r - s u - l ' i~ - n a
urticante|u r - tS i - k ' a~ - tS i
urticária|u r - tS i - k ' a - r j a
urtiga|u r - tS ' i - g a
urtigar|u r - tS i - g ' a r
uru|u - r ' u
urubu|u - r u - b ' u
urubu|u - r u - b ' u
uruguaio|u - r u - g w ' a j - u
urzal|u R - z ' a w
urze|' u R - z i
urzela|u R - z ' E - l a
urzelina|u R - z e - l ' i~ - n a
usado|u - z ' a - d u
usança|u - z ' a~ - s a
usar|u - z ' a r
usável|u - z ' a - v e w
usbeque|u Z - b ' E - k i
useiro|u - z ' e j - r u
usga|' u Z - g a
usina|u - z ' i~ - n a
usinar|u - z i~ - n ' a r
uso|' u - z u
ustir|u S - tS ' i r
usto|' u S - t u
usual|u - z u - ' a w
usual|u - z u - ' a w
usualmente|u - z u - a w - m ' e~ - tS i
usuário|u - z u - ' a - r j u
usucapião|u - z u - k a - p i - ' a~ w
usufruição|u - z u - f r w i - s ' a~ w
usufruidor|u - z u - f r w i - d ' o r
usufruir|u - z u - f r w ' i r
usufruto|u - z u - f r ' u - t u
usufrutuária|u - z u - f r u - t u - ' a - r j a
usufrutuário|u - z u - f r u - t u - ' a - r j u
usura|u - z ' u - r a
usurar|u - z u - r ' a r
usurária|u - z u - r ' a - r j a
usurariamente|u - z u - r a - r i - a~ - m ' e~ - tS i
usurário|u - z u - r ' a - r j u
usurpação|u - z u r - p a - s ' a~ w
usurpador|u - z u r - p a - d ' o r
usurpadora|u - z u r - p a - d ' o - r a
usurpar|u - z u r - p ' a r
ut|' u t
uta|' u - t a
utensilagem|u - t e~ - s i - l ' a - Z e~ j
utensílio|u - t e~ - s ' i - l j u
utente|u - t ' e~ - tS i
uterino|u - t e - r ' i~ - n u
útero|' u - t e - r u
útil|' u - tS i w
utilidade|u - tS i - l i - d ' a - dZ i
utilitária|u - tS i - l i - t ' a - r j a
utilitariamente|u - tS i - l i - t a - r i - a~ - m ' e~ - tS i
utilitário|u - tS i - l i - t ' a - r j u
utilitarismo|u - tS i - l i - t a - r ' i Z - m u
utilitarista|u - tS i - l i - t a - r ' i S - t a
utilização|u - tS i - l i - z a - s ' a~ w
utilizador|u - tS i - l i - z a - d ' o r
utilizadora|u - tS i - l i - z a - d ' o - r a
utilizar|u - tS i - l i - z ' a r
utilizável|u - tS i - l i - z ' a - v e w
utilmente|u - tS i w - m ' e~ - tS i
utopia|u - t o - p ' i - a
utopicamente|u - t O - p i - k a~ - m ' e~ - tS i
utópico|u - t ' O - p i - k u
utopismo|u - t o - p ' i Z - m u
utopista|u - t o - p ' i S - t a
uva|' u - v a
vaca|v ' a - k a
vacada|v a - k ' a - d a
vacante|v a - k ' a~ - tS i
vacar|v a - k ' a r
vacaria|v a - k a - r ' i - a
vacatura|v a - k a - t ' u - r a
vacilação|v a - s i - l a - s ' a~ w
vacilante|v a - s i - l ' a~ - tS i
vacilantemente|v a - s i - l a~ - t e~ - m ' e~ - tS i
vacilar|v a - s i - l ' a r
vacina|v a - s ' i~ - n a
vacinação|v a - s i~ - n a - s ' a~ w
vacinado|v a - s i~ - n ' a - d u
vacinal|v a - s i~ - n ' a w
vacinar|v a - s i~ - n ' a r
vacuidade|v a - k w i - d ' a - dZ i
vacum|v a - k ' u~
vácuo|v ' a - k w u
vácuo|v ' a - k w u
vadia|v a - dZ ' i - a
vadiagem|v a - dZ i - ' a - Z e~ j
vadiamente|v a - dZ i - a~ - m ' e~ - tS i
vadiar|v a - dZ i - ' a r
vadio|v a - dZ ' i - u
vaga|v ' a - g a
vagabunda|v a - g a - b ' u~ - d a
vagabundagem|v a - g a - b u~ - d ' a - Z e~ j
vagabundar|v a - g a - b u~ - d ' a r
vagabundear|v a - g a - b u~ - dZ i - ' a r
vagabundo|v a - g a - b ' u~ - d u
vagalhão|v a - g a - L ' a~ w
vagamente|v a - g a~ - m ' e~ - tS i
vagamundo|v a - g a~ - m ' u~ - d u
vagão|v a - g ' a~ w
vagãorestaurante|v a - g ˌ a~ w - R e S - t a w - r ' a~ - tS i
vagar|v a - g ' a r
vagar|v a - g ' a r
vagarosa|v a - g a - r ' O - z a
vagarosamente|v a - g a - r o - z a~ - m ' e~ - tS i
vagaroso|v a - g a - r ' o - z u
vagem|v ' a - Z e~ j
vagido|v a - Z ' i - d u
vagina|v a - Z ' i~ - n a
vaginal|v a - Z i~ - n ' a w
vaginismo|v a - Z i~ - n ' i Z - m u
vagir|v a - Z ' i r
vago|v ' a - g u
vagoneta|v a - g o~ - n ' e - t a
vagonete|v a - g o~ - n ' E - tS i
vaguear|v a - g i - ' a r
vagueira|v a - g ' e j - r a
vagueiro|v a - g ' e j - r u
vaguense|v a - g ' e~ - s i
vaguíssimo|v a - g ' i - s i~ - m u
vainãovai|v ˌ a j - n a~ w - v ' a j
vaia|v ' a j - a
vaiar|v a j - ' a r
vaidade|v a j - d ' a - dZ i
vaidosa|v a j - d ' O - z a
vaidosamente|v a j - d O - z a~ - m ' e~ - tS i
vaidoso|v a j - d ' o - z u
vairão|v a j - r ' a~ w
vaivém|v a j - v ' e~ j
vala|v ' a - l a
valada|v a - l ' a - d a
valado|v a - l ' a - d u
valador|v a - l a - d ' o r
valão|v a - l ' a~ w
valáquia|v a - l ' a - k j a
valáquio|v a - l ' a - k j u
valar|v a - l ' a r
valboense|v a w - b w ' e~ - s i
valdense|v a w - d ' e~ - s i
valdevinos|v a w - d e - v ' i~ - n u S
valdo|v ' a w - d u
vale|v ' a - l i
valecambrense|v ˌ a - l i - k a~ - b r ' e~ - s i
valedor|v a - l e - d ' o r
valeira|v a - l ' e j - r a
valeiro|v a - l ' e j - r u
valejo|v a - l ' e - Z u
valência|v a - l ' e~ - s j a
valenciana|v a - l e~ - s i - ' a~ - n a
valenciano|v a - l e~ - s i - ' a~ - n u
valentão|v a - l e~ - t ' a~ w
valente|v a - l ' e~ - tS i
valentemente|v a - l e~ - t e~ - m ' e~ - tS i
valentia|v a - l e~ - tS ' i - a
valer|v a - l ' e r
valeriana|v a - l e - r i - ' a~ - n a
valerosamente|v a - l e - r O - z a~ - m ' e~ - tS i
valeroso|v a - l e - r ' o - z u
valete|v a - l ' E - tS i
valia|v a - l ' i - a
valida|v a - l ' i - d a
validação|v a - l i - d a - s ' a~ w
validade|v a - l i - d ' a - dZ i
validamente|v a - l i - d a~ - m ' e~ - tS i
validar|v a - l i - d ' a r
validez|v a - l i - d ' e S
valido|v a - l ' i - d u
válido|v ' a - l i - d u
valimento|v a - l i~ - m ' e~ - t u
valiosamente|v a - l j O - z a~ - m ' e~ - tS i
valioso|v a - l j ' o - z u
valo|v ' a - l u
valonguense|v a - l o~ - g ' e~ - s i
valor|v a - l ' o r
valorbase|v a - l ˌ o r - b ' a - z i
valoração|v a - l o - r a - s ' a~ w
valorado|v a - l o - r ' a - d u
valorar|v a - l o - r ' a r
valorativo|v a - l o - r a - tS ' i - v u
valorização|v a - l o - r i - z a - s ' a~ w
valorizado|v a - l o - r i - z ' a - d u
valorizador|v a - l o - r i - z a - d ' o r
valorizadora|v a - l o - r i - z a - d ' o - r a
valorizar|v a - l o - r i - z ' a r
valorizável|v a - l o - r i - z ' a - v e w
valorosamente|v a - l o - r O - z a~ - m ' e~ - tS i
valoroso|v a - l o - r ' o - z u
valpacense|v a w - p a - s ' e~ - s i
valquíria|v a w - k ' i - r j a
valsa|v ' a w - s a
valsar|v a w - s ' a r
valverde|v a w - v ' e R - dZ i
válvula|v ' a w - v u - l a
valvular|v a w - v u - l ' a r
vampe|v ' a~ - p i
vampírico|v a~ - p ' i - r i - k u
vampirismo|v a~ - p i - r ' i Z - m u
vampirizar|v a~ - p i - r i - z ' a r
vampiro|v a~ - p ' i - r u
vanádio|v a~ - n ' a - dZ j u
vandalismo|v a~ - d a - l ' i Z - m u
vandalização|v a~ - d a - l i - z a - s ' a~ w
vandalizar|v a~ - d a - l i - z ' a r
vândalo|v ' a~ - d a - l u
vanglória|v a~ - g l ' O - r j a
vangloriar|v a~ - g l o - r i - ' a r
vanguarda|v a~ - g w ' a R - d a
vanguardismo|v a~ - g w a R - dZ ' i Z - m u
vanguardista|v a~ - g w a R - dZ ' i S - t a
vanidade|v a~ - n i - d ' a - dZ i
vantagem|v a~ - t ' a - Z e~ j
vantajosamente|v a~ - t a - Z O - z a~ - m ' e~ - tS i
vantajoso|v a~ - t a - Z ' o - z u
vante|v ' a~ - tS i
vão|v ' a~ w
vão|v ' a~ w
vapor|v a - p ' o r
vaporar|v a - p o - r ' a r
vaporização|v a - p o - r i - z a - s ' a~ w
vaporizador|v a - p o - r i - z a - d ' o r
vaporizar|v a - p o - r i - z ' a r
vaporosamente|v a - p o - r O - z a~ - m ' e~ - tS i
vaporoso|v a - p o - r ' o - z u
vaqueira|v a - k ' e j - r a
vaqueiro|v a - k ' e j - r u
vaquinha|v a - k ' i~ - J a
vara|v ' a - r a
varada|v a - r ' a - d a
varado|v a - r ' a - d u
varadouro|v a - r a - d ' o - r u
varal|v a - r ' a w
varanda|v a - r ' a~ - d a
varandim|v a - r a~ - dZ ' i ̃
varão|v a - r ' a~ w
varapau|v a - r a - p ' a w
varar|v a - r ' a r
vareira|v a - r ' e j - r a
vareiro|v a - r ' e j - r u
varejão|v a - r e - Z ' a~ w
varejar|v a - r e - Z ' a r
varejeira|v a - r e - Z ' e j - r a
varejeiro|v a - r e - Z ' e j - r u
varejo|v a - r ' e - Z u
varela|v a - r ' E - l a
vareta|v a - r ' e - t a
varga|v ' a R - g a
vargem|v ' a R - Z e~ j
vária|v ' a - r j a
variabilidade|v a - r i - a - b i - l i - d ' a - dZ i
variação|v a - r i - a - s ' a~ w
variadamente|v a - r i - a - d a~ - m ' e~ - tS i
variadíssimo|v a - r i - a - dZ ' i - s i~ - m u
variado|v a - r i - ' a - d u
variamente|v a - r i - a~ - m ' e~ - tS i
variância|v a - r i - ' a~ - s j a
variante|v a - r i - ' a~ - tS i
variar|v a - r i - ' a r
variável|v a - r i - ' a - v e w
variavelmente|v a - r i - a - v e w - m ' e~ - tS i
varicela|v a - r i - s ' E - l a
varicelar|v a - r i - s e - l ' a r
variedade|v a - r j e - d ' a - dZ i
variegadamente|v a - r i - E - g a - d a~ - m ' e~ - tS i
variegado|v a - r i - E - g ' a - d u
variegar|v a - r i - E - g ' a r
varinha|v a - r ' i~ - J a
varino|v a - r ' i~ - n u
varino|v a - r ' i~ - n u
vário|v ' a - r j u
varíola|v a - r ' i - o - l a
variz|v a - r ' i S
varjão|v a R - Z ' a~ w
varonia|v a - r o~ - n ' i - a
varonil|v a - r o~ - n ' i w
varonilmente|v a - r o~ - n i w - m ' e~ - tS i
varrasco|v a - R ' a S - k u
varredela|v a - R e - d ' E - l a
varredor|v a - R e - d ' o r
varredora|v a - R e - d ' o - r a
varredoura|v a - R e - d ' o - r a
varredura|v a - R e - d ' u - r a
varrer|v a - R ' e r
varrida|v a - R ' i - d a
varrido|v a - R ' i - d u
varrido|v a - R ' i - d u
varsoviana|v a r - s o - v i - ' a~ - n a
varsoviano|v a r - s o - v i - ' a~ - n u
várzea|v ' a R - z j a
varzim|v a R - z ' i~
vasa|v ' a - z a
vasca|v ' a S - k a
vascão|v a S - k ' a~ w
vasco|v ' a S - k u
vascular|v a S - k u - l ' a r
vascularização|v a S - k u - l a - r i - z a - s ' a~ w
vasculhar|v a S - k u - L ' a r
vasectomia|v a - z e - k ə - t o~ - m ' i - a
vaselina|v a - z e - l ' i~ - n a
vasilha|v a - z ' i - L a
vasilhame|v a - z i - L ' a~ - m i
vaso|v ' a - z u
vasodilatador|v a - z o - dZ i - l a - t a - d ' o r
vasopressina|v a - z O - p r e - s ' i~ - n a
vassalagem|v a - s a - l ' a - Z e~ j
vassalo|v a - s ' a - l u
vassoura|v a - s ' o - r a
vassourada|v a - s o - r ' a - d a
vassourar|v a - s o - r ' a r
vassourinha|v a - s o - r ' i~ - J a
vastamente|v a S - t a~ - m ' e~ - tS i
vastar|v a S - t ' a r
vastidão|v a S - tS i - d ' a~ w
vastíssimo|v a S - tS ' i - s i~ - m u
vasto|v ' a S - t u
vatapá|v a - t a - p ' a
vate|v ' a - tS i
vaticanista|v a - tS i - k a~ - n ' i S - t a
vaticano|v a - tS i - k ' a~ - n u
vaticinar|v a - tS i - s i~ - n ' a r
vaticínio|v a - tS i - s ' i~ - n j u
vátua|v ' a - t u - a
vau|v ' a w
vaza|v ' a - z a
vazado|v a - z ' a - d u
vazadouro|v a - z a - d ' o - r u
vazamento|v a - z a~ - m ' e~ - t u
vazante|v a - z ' a~ - tS i
vazão|v a - z ' a~ w
vazar|v a - z ' a r
vazia|v a - z ' i - a
vaziamente|v a - z i - a~ - m ' e~ - tS i
vaziar|v a - z i - ' a r
vazio|v a - z ' i - u
vazio|v a - z ' i - u
vazo|v ' a - z u
vê|v ' e
vêloemos|v ˌ e - l u - ' e~ - m u S
veado|v i - ' a - d u
veador|v e - a - d ' o r
vectorial|v e - k ə - t o - r i - ' a w
vectorizar|v e - k ə - t o - r i - z ' a r
veda|v ' E - d a
vedação|v e - d a - s ' a~ w
vedado|v e - d ' a - d u
vedar|v e - d ' a r
vedeta|v e - d ' e - t a
vedetismo|v e - d e - tS ' i Z - m u
védico|v ' E - dZ i - k u
vedor|v E - d ' o r
vedoria|v E - d o - r ' i - a
vedro|v ' E - d r u
vedro|v ' E - d r u
veemência|v e - e~ - m ' e~ - s j a
veemente|v e - e~ - m ' e~ - tS i
veementemente|v e - e~ - m e~ - t e~ - m ' e~ - tS i
vegetação|v e - Z e - t a - s ' a~ w
vegetal|v e - Z e - t ' a w
vegetalista|v e - Z e - t a - l ' i S - t a
vegetar|v e - Z e - t ' a r
vegetariana|v e - Z e - t a - r i - ' a~ - n a
vegetarianismo|v e - Z e - t a - r i - a~ - n ' i Z - m u
vegetariano|v e - Z e - t a - r i - ' a~ - n u
vegetativamente|v e - Z e - t a - tS i - v a~ - m ' e~ - tS i
vegetativo|v e - Z e - t a - tS ' i - v u
veia|v ' e j - a
veiculação|v e j - k u - l a - s ' a~ w
veiculador|v e j - k u - l a - d ' o r
veicular|v e j - k u - l ' a r
veículo|v e - ' i - k u - l u
veiga|v ' e j - g a
veio|v ' e j - u
veiro|v ' e j - r u
vela|v ' E - l a
velada|v e - l ' a - d a
veladamente|v e - l a - d a~ - m ' e~ - tS i
velado|v e - l ' a - d u
velador|v e - l a - d ' o r
veladora|v e - l a - d ' o - r a
velame|v e - l ' a~ - m i
velar|v e - l ' a r
velatura|v e - l a - t ' u - r a
velcro|v ' E w - k r u
veleidade|v e - l e j - d ' a - dZ i
veleiro|v e - l ' e j - r u
velejador|v e - l e - Z a - d ' o r
velejar|v e - l e - Z ' a r
veleta|v e - l ' e - t a
velha|v ' E - L a
velhaca|v E - L ' a - k a
velhacamente|v e - L a - k a~ - m ' e~ - tS i
velhacaria|v e - L a - k a - r ' i - a
velhaco|v e - L ' a - k u
velhada|v E - L ' a - d a
velharia|v e - L a - r ' i - a
velhice|v e - L ' i - s i
velhinha|v e - L ' i~ - J a
velhinho|v e - L ' i~ - J u
velho|v ' E - L u
velho|v ' E - L u
velhote|v e - L ' O - tS i
velinha|v e - l ' i~ - J a
velo|v ' E - l u
velocidade|v e - l o - s i - d ' a - dZ i
velocímetro|v e - l o - s ' i~ - m e - t r u
velocípede|v e - l o - s ' i - p e - dZ i
velocipedia|v e - l o - s i - p e - dZ ' i - a
velocipédico|v e - l o - s i - p ' E - dZ i - k u
velocíssimo|v e - l o - s ' i - s i~ - m u
velocista|v e - l o - s ' i S - t a
velódromo|v e - l ' O - d r o~ - m u
velório|v e - l ' O - r j u
veloso|v e - l ' o - z u
veloz|v e - l ' O S
velozmente|v e - l o Z - m ' e~ - tS i
veludo|v e - l ' u - d u
veludo|v e - l ' u - d u
venal|v e~ - n ' a w
venalidade|v e~ - n a - l i - d ' a - dZ i
venalmente|v e~ - n a w - m ' e~ - tS i
venatório|v e~ - n a - t ' O - r j u
vencedor|v e~ - s e - d ' o r
vencedora|v e~ - s e - d ' o - r a
vencer|v e~ - s ' e r
vencida|v e~ - s ' i - d a
vencido|v e~ - s ' i - d u
vencimento|v e~ - s i~ - m ' e~ - t u
venda|v ' e~ - d a
vendado|v e~ - d ' a - d u
vendagem|v e~ - d ' a - Z e~ j
vendar|v e~ - d ' a r
vendaval|v e~ - d a - v ' a w
vendável|v e~ - d ' a - v e w
vendedeira|v e~ - d e - d ' e j - r a
vendedor|v e~ - d e - d ' o r
vendedora|v e~ - d e - d ' o - r a
vender|v e~ - d ' e r
vendeta|v e~ - d ' e - t a
vendida|v e~ - dZ ' i - d a
vendido|v e~ - dZ ' i - d u
vendilhão|v e~ - dZ i - L ' a~ w
veneno|v e~ - n ' e~ - n u
venenosamente|v e~ - n e~ - n O - z a~ - m ' e~ - tS i
venenoso|v e~ - n e~ - n ' o - z u
venera|v e~ - n ' E - r a
veneração|v e~ - n e - r a - s ' a~ w
veneradamente|v e~ - n e - r a - d a~ - m ' e~ - tS i
venerado|v e~ - n e - r ' a - d u
venerador|v e~ - n e - r a - d ' o r
venerando|v e~ - n e - r ' a~ - d u
venerar|v e~ - n e - r ' a r
venerável|v e~ - n e - r ' a - v e w
veneravelmente|v e~ - n e - r a - v e w - m ' e~ - tS i
venéreo|v e~ - n ' E - r j u
venereologia|v e~ - n e - r j o - l o - Z ' i - a
veneta|v e~ - n ' e - t a
véneto|v ' e~ - n e - t u
veneziana|v e~ - n e - z i - ' a~ - n a
veneziano|v e~ - n e - z i - ' a~ - n u
venezuelano|v e~ - n e - z u - e - l ' a~ - n u
vénia|v ' e~ - n j a
veniaga|v e~ - n i - ' a - g a
veniagar|v e~ - n i - a - g ' a r
venial|v e~ - n i - ' a w
venialidade|v e~ - n i - a - l i - d ' a - dZ i
venialmente|v e~ - n i - a w - m ' e~ - tS i
venoso|v e~ - n ' o - z u
venta|v ' e~ - t a
ventania|v e~ - t a~ - n ' i - a
ventar|v e~ - t ' a r
ventarola|v e~ - t a - r ' O - l a
ventilação|v e~ - tS i - l a - s ' a~ w
ventilado|v e~ - tS i - l ' a - d u
ventilador|v e~ - tS i - l a - d ' o r
ventilar|v e~ - tS i - l ' a r
vento|v ' e~ - t u
ventoinha|v e~ - t w ' i~ - J a
ventoinhar|v e~ - t w i~ - J ' a r
ventosa|v e~ - t ' O - z a
ventosidade|v e~ - t o - z i - d ' a - dZ i
ventoso|v e~ - t ' o - z u
ventral|v e~ - t r ' a w
ventre|v ' e~ - t r i
ventricular|v e~ - t r i - k u - l ' a r
ventrículo|v e~ - t r ' i - k u - l u
ventriloquismo|v e~ - t r i - l o - k ' i Z - m u
ventríloquo|v e~ - t r ' i - l o - k u
ventura|v e~ - t ' u - r a
ventureiro|v e~ - t u - r ' e j - r u
venturo|v e~ - t ' u - r u
venturosamente|v e~ - t u - r O - z a~ - m ' e~ - tS i
venturoso|v e~ - t u - r ' o - z u
vénus|v ' e~ - n u S
venusiano|v e~ - n u - z i - ' a~ - n u
ver|v ' e r
veracidade|v e - r a - s i - d ' a - dZ i
veramente|v E - r a~ - m ' e~ - tS i
veraneante|v e - r a~ - n i - ' a~ - tS i
veranear|v e - r a~ - n i - ' a r
veraneio|v e - r a~ - n ' e j - u
veras|v ' E - r a S
veraz|v e - r ' a S
verba|v ' E R - b a
verbal|v e R - b ' a w
verbalismo|v e R - b a - l ' i Z - m u
verbalista|v e R - b a - l ' i S - t a
verbalização|v e R - b a - l i - z a - s ' a~ w
verbalizado|v e R - b a - l i - z ' a - d u
verbalizar|v e R - b a - l i - z ' a r
verbalmente|v e R - b a w - m ' e~ - tS i
verbena|v e R - b ' e~ - n a
verberar|v e R - b e - r ' a r
verbetar|v e R - b e - t ' a r
verbete|v e R - b ' e - tS i
verbo|v ' E R - b u
verborreia|v e R - b o - R ' e j - a
verbosamente|v e R - b O - z a~ - m ' e~ - tS i
verbosidade|v e R - b o - z i - d ' a - dZ i
verboso|v e R - b ' o - z u
verdade|v e R - d ' a - dZ i
verdadeiramente|v e R - d a - d e j - r a~ - m ' e~ - tS i
verdadeiro|v e R - d a - d ' e j - r u
verdadeiro|v e R - d a - d ' e j - r u
verdasca|v e R - d ' a S - k a
verdascar|v e R - d a S - k ' a r
verdasco|v e R - d ' a S - k u
verde|v ' e R - dZ i
verdealface|v ˌ e R - dZ i - a w - f ' a - s i
verdeamarelado|v ˌ e R - dZ i - a~ - m a - r e - l ' a - d u
verdeazeitona|v ˌ e R - dZ i - a - z e j - t ' o~ - n a
verdeclaro|v ˌ e R - dZ i - k l ' a - r u
verdeescuro|v ˌ e R - dZ i - i S - k ' u - r u
verdeesmeralda|v ˌ e R - dZ i - i Z - m e - r ' a w - d a
verdegarrafa|v ˌ e R - dZ i - g a - R ' a - f a
verdemar|v ˌ e R - dZ i - m ' a r
verdemar|v ˌ e R - dZ i - m ' a r
verderubro|v ˌ e R - dZ i - R ' u - b r u
verdeal|v e R - dZ i - ' a w
verdegar|v e R - d e - g ' a r
verdejante|v e R - d e - Z ' a~ - tS i
verdejar|v e R - d e - Z ' a r
verdelha|v e R - d ' e - L a
verdelho|v e R - d ' e - L u
verdete|v e R - d ' e - tS i
verdilhão|v e R - dZ i - L ' a~ w
verdugo|v e R - d ' u - g u
verdura|v e R - d ' u - r a
vereação|v e - r e - a - s ' a~ w
vereador|v e - r e - a - d ' o r
vereadora|v e - r e - a - d ' o - r a
vereda|v e - r ' e - d a
veredicto|v e - r e - dZ ' i - k ə - t u
verga|v ' e R - g a
vergado|v e R - g ' a - d u
vergalhar|v e R - g a - L ' a r
vergalho|v e R - g ' a - L u
vergão|v e R - g ' a~ w
vergar|v e R - g ' a r
vergasta|v e R - g ' a S - t a
vergastada|v e R - g a S - t ' a - d a
vergastar|v e R - g a S - t ' a r
vergel|v e R - Z ' E w
vergonha|v e R - g ' u~ - J a
vergonhosa|v e R - g o~ - J ' O - z a
vergonhosamente|v e R - g o~ - J o - z a~ - m ' e~ - tS i
vergonhoso|v e R - g o~ - J ' o - z u
vergueiro|v e R - g ' e j - r u
verguinha|v e R - g ' i~ - J a
veridicamente|v e - r i - dZ i - k a~ - m ' e~ - tS i
verídico|v e - r ' i - dZ i - k u
verificação|v e - r i - f i - k a - s ' a~ w
verificado|v e - r i - f i - k ' a - d u
verificador|v e - r i - f i - k a - d ' o r
verificar|v e - r i - f i - k ' a r
verificável|v e - r i - f i - k ' a - v e w
verismo|v e - r ' i Z - m u
verista|v e - r ' i S - t a
verme|v ' E R - m i
vermelha|v e R - m ' e - L a
vermelhão|v e R - m e - L ' a~ w
vermelhar|v e R - m e - L ' a r
vermelhidão|v e R - m e - L i - d ' a~ w
vermelhinha|v e R - m e - L ' i~ - J a
vermelhinho|v e R - m e - L ' i~ - J u
vermelho|v e R - m ' e - L u
vermelhoescuro|v e R - m ˌ e - L u - i S - k ' u - r u
vermelhoescuro|v e R - m ˌ e - L u - i S - k ' u - r u
vermelhoso|v e R - m e - L ' o - z u
vermelhusco|v e R - m e - L ' u S - k u
vermute|v e R - m ' u - tS i
verna|v ' E R - n a
vernaculamente|v e R - n a - k u - l a~ - m ' e~ - tS i
vernaculidade|v e R - n a - k u - l i - d ' a - dZ i
vernáculo|v e R - n ' a - k u - l u
vernal|v e R - n ' a w
vernar|v e R - n ' a r
verne|v ' E R - n i
vernissage|v e R - n i - s ' a - Z i
verniz|v e R - n ' i S
verno|v ' E R - n u
vero|v ' E - r u
veronal|v e - r o~ - n ' a w
verónica|v e - r ' u~ - n i - k a
verosímil|v e - r o - z ' i~ - m i w
verosimilhança|v e - r o - z i~ - m i - L ' a~ - s a
verosimilhante|v e - r o - z i~ - m i - L ' a~ - tS i
verosimilmente|v e - r o - z i~ - m i w - m ' e~ - tS i
verrina|v e - R ' i~ - n a
verrinar|v e - R i~ - n ' a r
verrinosamente|v e - R i~ - n O - z a~ - m ' e~ - tS i
verrinoso|v e - R i~ - n ' o - z u
verruga|v e - R ' u - g a
versa|v ' E r - s a
versado|v e r - s ' a - d u
versalhada|v e r - s a - L ' a - d a
versão|v e r - s ' a~ w
versar|v e r - s ' a r
versaria|v e r - s a - r ' i - a
versátil|v e r - s ' a - tS i w
versatilidade|v e r - s a - tS i - l i - d ' a - dZ i
versatilmente|v e r - s a - tS i w - m ' e~ - tS i
versejador|v e r - s e - Z a - d ' o r
versejar|v e r - s e - Z ' a r
versículo|v e r - s ' i - k u - l u
versificação|v e r - s i - f i - k a - s ' a~ w
versificador|v e r - s i - f i - k a - d ' o r
verso|v ' E r - s u
vértebra|v ' E r - t e - b r a
vertebrado|v e r - t e - b r ' a - d u
vertebral|v e r - t e - b r ' a w
vertebrar|v e r - t e - b r ' a r
vertente|v e r - t ' e~ - tS i
verter|v e r - t ' e r
vertical|v e r - tS i - k ' a w
verticalidade|v e r - tS i - k a - l i - d ' a - dZ i
verticalização|v e r - tS i - k a - l i - z a - s ' a~ w
verticalizar|v e r - tS i - k a - l i - z ' a r
verticalmente|v e r - tS i - k a w - m ' e~ - tS i
vértice|v ' E r - tS i - s i
verticilo|v e r - tS i - s ' i - l u
vertigem|v e r - tS ' i - Z e~ j
vertiginosamente|v e r - tS i - Z i~ - n o - z a~ - m ' e~ - tS i
vertiginoso|v e r - tS i - Z i~ - n ' o - z u
verve|v ' E R - v i
vesco|v ' e S - k u
vesga|v ' e Z - g a
vesgamente|v e Z - g a~ - m ' e~ - tS i
vesgo|v ' e Z - g u
vesicante|v e - z i - k ' a~ - tS i
vesícula|v e - z ' i - k u - l a
vesicular|v e - z i - k u - l ' a r
vesiculoso|v e - z i - k u - l ' o - z u
vespa|v ' e S - p a
vespeiro|v e S - p ' e j - r u
véspera|v ' E S - p e - r a
vespertino|v e S - p e r - tS ' i~ - n u
vessada|v e - s ' a - d a
vessadoiro|v e - s a - d ' o j - r u
vessar|v e - s ' a r
vestal|v e S - t ' a w
veste|v ' E S - tS i
véstia|v ' E S - tS j a
vestiaria|v e S - tS i - a - r ' i - a
vestiário|v e S - tS i - ' a - r j u
vestibular|v e S - tS i - b u - l ' a r
vestíbulo|v e S - tS ' i - b u - l u
vestido|v e S - tS ' i - d u
vestígio|v e S - tS ' i - Z j u
vestimenta|v e S - tS i~ - m ' e~ - t a
vestir|v e S - tS ' i r
vestuário|v e S - t u - ' a - r j u
vetar|v e - t ' a r
veterana|v e - t e - r ' a~ - n a
veterano|v e - t e - r ' a~ - n u
veterinária|v e - t e - r i~ - n ' a - r j a
veterinariamente|v e - t e - r i~ - n a - r i - a~ - m ' e~ - tS i
veterinário|v e - t e - r i~ - n ' a - r j u
vetiver|v e - tS i - v ' E r
veto|v ' E - t u
vetor|v e - t ' o r
vetustamente|v e - t u S - t a~ - m ' e~ - tS i
vetustez|v e - t u S - t ' e S
vetusto|v e - t ' u S - t u
véu|v ' E w
vexado|v e - S ' a - d u
vexame|v e - S ' a~ - m i
vexante|v e - S ' a~ - tS i
vexar|v e - S ' a r
vexatoriamente|v e - S a - t O - r i - a~ - m ' e~ - tS i
vexatório|v e - S a - t ' O - r j u
vez|v ' e S
vezar|v e - z ' a r
vezeira|v e - z ' e j - r a
vezeiro|v e - z ' e j - r u
vezo|v ' e - z u
via|v ' i - a
viaférrea|v ˌ i - a - f ' E - R j a
viasacra|v ˌ i - a - s ' a - k r a
viabilidade|v i - a - b i - l i - d ' a - dZ i
viabilização|v i - a - b i - l i - z a - s ' a~ w
viabilizar|v i - a - b i - l i - z ' a r
viação|v i - a - s ' a~ w
viaduto|v i - a - d ' u - t u
viageiro|v i - a - Z ' e j - r u
viagem|v i - ' a - Z e~ j
viagenzinha|v i - a - Z e~ j - z ' i~ - J a
viajada|v i - a - Z ' a - d a
viajado|v i - a - Z ' a - d u
viajante|v i - a - Z ' a~ - tS i
viajar|v i - a - Z ' a r
vial|v i - ' a w
vianda|v i - ' a~ - d a
viandante|v i - a~ - d ' a~ - tS i
viandar|v i - a~ - d ' a r
vianense|v i - a~ - n ' e~ - s i
vianês|v i - a~ - n ' e S
viário|v i - ' a - r j u
viário|v i - ' a - r j u
viático|v i - ' a - tS i - k u
viatura|v i - a - t ' u - r a
viável|v i - ' a - v e w
víbora|v ' i - b o - r a
víboracornuda|v ˌ i - b o - r a - k o R - n ' u - d a
vibração|v i - b r a - s ' a~ w
vibrador|v i - b r a - d ' o r
vibrafone|v i - b r a - f ' u~ - n i
vibrafonista|v i - b r a - f o~ - n ' i S - t a
vibrante|v i - b r ' a~ - tS i
vibrantemente|v i - b r a~ - t e~ - m ' e~ - tS i
vibrar|v i - b r ' a r
vibrátil|v i - b r ' a - tS i w
vibrato|v i - b r ' a - t u
vibratoriamente|v i - b r a - t O - r i - a~ - m ' e~ - tS i
vibratório|v i - b r a - t ' O - r j u
vibrião|v i - b r i - ' a~ w
viçar|v i - s ' a r
vicariato|v i - k a - r i - ' a - t u
vicário|v i - k ' a - r j u
vicealmirante|v ˌ i - s i - a w - m i - r ' a~ - tS i
vicecampeã|v ˌ i - s i - k a~ - p i - ' a~
vicecampeão|v ˌ i - s i - k a~ - p e - ' a~ w
vicecampeonato|v ˌ i - s i - k a~ - p j o~ - n ' a - t u
vicechanceler|v ˌ i - s i - S a~ - s e - l ' E r
vicechefe|v ˌ i - s i - S ' E - f i
vicechefia|v ˌ i - s i - S e - f ' i - a
vicecomissário|v ˌ i - s i - k o~ - m i - s ' a - r j u
vicediretor|v ˌ i - s i - dZ i - r e - t ' o r
vicegovernador|v ˌ i - s i - g o - v e R - n a - d ' o r
vicelíder|v ˌ i - s i - l ' i - d e r
viceministro|v ˌ i - s i - m i~ - n ' i S - t r u
vicepresidência|v ˌ i - s i - p r e - z i - d ' e~ - s j a
vicepresidente|v ˌ i - s i - p r e - z i - d ' e~ - tS i
vicerei|v ˌ i - s i - R ' e j
vicereinado|v ˌ i - s i - R e~ j - n ' a - d u
vicereino|v ˌ i - s i - R ' e~ j - n u
vicereitor|v ˌ i - s i - R e j - t ' o r
vicesecretária|v ˌ i - s i - s e - k r e - t ' a - r j a
vicesecretário|v ˌ i - s i - s e - k r e - t ' a - r j u
viceversa|v ˌ i - s i - v ' E r - s a
vicejante|v i - s e - Z ' a~ - tS i
vicejar|v i - s e - Z ' a r
vicente|v i - s ' e~ - tS i
vicentina|v i - s e~ - tS ' i~ - n a
vicentino|v i - s e~ - tS ' i~ - n u
vicentista|v i - s e~ - tS ' i S - t a
viciação|v i - s i - a - s ' a~ w
viciada|v i - s i - ' a - d a
viciado|v i - s i - ' a - d u
viciante|v i - s i - ' a~ - tS i
viciar|v i - s i - ' a r
vicinal|v i - s i~ - n ' a w
vício|v ' i - s j u
viciosa|v i - s j ' O - z a
viciosamente|v i - s j O - z a~ - m ' e~ - tS i
viciosidade|v i - s j o - z i - d ' a - dZ i
vicioso|v i - s j ' o - z u
vicissitude|v i - s i - s i - t ' u - dZ i
viço|v ' i - s u
viçosamente|v i - s O - z a~ - m ' e~ - tS i
viçoso|v i - s ' o - z u
vicunha|v i - k ' u~ - J a
vida|v ' i - d a
vidar|v i - d ' a r
vidar|v i - d ' a r
vide|v ' i - dZ i
videasta|v i - dZ i - ' a S - t a
videira|v i - d ' e j - r a
videirinho|v i - d e j - r ' i~ - J u
videirismo|v i - d e j - r ' i Z - m u
videiro|v i - d ' e j - r u
vidência|v i - d ' e~ - s j a
vidente|v i - d ' e~ - tS i
vídeo|v ' i - dZ j u
videoamador|v i - dZ j o - a~ - m a - d ' o r
videoarte|v i - dZ j o - ' a r - tS i
videocassete|v i - dZ j o - k a - s ' E - tS i
videoclipe|v i - dZ j o - k l ' i - p i
videoclube|v i - dZ j o - k l ' u - b i
videoconferência|v i - dZ j o - k o~ - f e - r ' e~ - s j a
videodisco|v i - dZ j o - dZ ' i S - k u
videofone|v i - dZ j o - f ' u~ - n i
videograma|v i - dZ j o - g r ' a~ - m a
videogravador|v i - dZ j o - g r a - v a - d ' o r
videojogo|v i - dZ j o - Z ' o - g u
videoteca|v i - dZ j o - t ' E - k a
videotelefone|v i - dZ j o - t e - l e - f ' u~ - n i
videotexto|v i - dZ j o - t ' e S - t u
videovigilância|v i - dZ j o - v i - Z i - l ' a~ - s j a
vidinha|v i - dZ ' i~ - J a
vido|v ' i - d u
vidoeiro|v i - d w ' e j - r u
vidraça|v i - d r ' a - s a
vidraceiro|v i - d r a - s ' e j - r u
vidraço|v i - d r ' a - s u
vidrado|v i - d r ' a - d u
vidragem|v i - d r ' a - Z e~ j
vidrão|v i - d r ' a~ w
vidrar|v i - d r ' a r
vidreira|v i - d r ' e j - r a
vidreiro|v i - d r ' e j - r u
vidrinho|v i - d r ' i~ - J u
vidro|v ' i - d r u
vieira|v j ' e j - r a
vieirense|v j e j - r ' e~ - s i
viela|v j ' E - l a
vienense|v j e~ - n ' e~ - s i
viés|v j ' E S
vietnamita|v j e - t ə ̃ - n a~ - m ' i - t a
vietnamita|v j e - t ə ̃ - n a~ - m ' i - t a
viga|v ' i - g a
vigamento|v i - g a~ - m ' e~ - t u
vigar|v i - g ' a r
vigária|v i - g ' a - r j a
vigarice|v i - g a - r ' i - s i
vigário|v i - g ' a - r j u
vigáriogeral|v i - g ˌ a - r j u - Z e - r ' a w
vigarista|v i - g a - r ' i S - t a
vigarizar|v i - g a - r i - z ' a r
vigência|v i - Z ' e~ - s j a
vigente|v i - Z ' e~ - tS i
viger|v i - Z ' e r
vigésimo|v i - Z ' E - z i~ - m u
vigia|v i - Z ' i - a
vigia|v i - Z ' i - a
vigiar|v i - Z i - ' a r
vigilância|v i - Z i - l ' a~ - s j a
vigilante|v i - Z i - l ' a~ - tS i
vigilantemente|v i - Z i - l a~ - t e~ - m ' e~ - tS i
vigília|v i - Z ' i - l j a
vigor|v i - g ' o r
vigorar|v i - g o - r ' a r
vigorosamente|v i - g o - r o - z a~ - m ' e~ - tS i
vigoroso|v i - g o - r ' o - z u
vil|v ' i w
vila|v ' i - l a
vilacondense|v ˌ i - l a - k o~ - d ' e~ - s i
vilafranquense|v ˌ i - l a - f r a~ - k ' e~ - s i
vilarealense|v ˌ i - l a - R e - a - l ' e~ - s i
vilaverdense|v ˌ i - l a - v e R - d ' e~ - s i
vilanagem|v i - l a~ - n ' a - Z e~ j
vilancete|v i - l a~ - s ' e - tS i
vilancico|v i - l a~ - s ' i - k u
vilania|v i - l a~ - n ' i - a
vilão|v i - l ' a~ w
vilar|v i - l ' a r
vilarejo|v i - l a - r ' e - Z u
vilarelho|v i - l a - r ' e - L u
vilarinho|v i - l a - r ' i~ - J u
vilegiatura|v i - l e - Z i - a - t ' u - r a
vilegiaturar|v i - l e - Z i - a - t u - r ' a r
vilela|v i - l ' E - l a
vileza|v i - l ' e - z a
vilipendiado|v i - l i - p e~ - dZ i - ' a - d u
vilipendiar|v i - l i - p e~ - dZ i - ' a r
vilipêndio|v i - l i - p ' e~ - dZ j u
vilmente|v i w - m ' e~ - tS i
vilória|v i - l ' O - r j a
vilosidade|v i - l o - z i - d ' a - dZ i
vima|v ' i~ - m a
vimaranense|v i~ - m a - r a~ - n ' e~ - s i
vime|v ' i~ - m i
vimeiro|v i~ - m ' e j - r u
vimieiro|v i~ - m j ' e j - r u
vina|v ' i~ - n a
vinagrar|v i~ - n a - g r ' a r
vinagre|v i~ - n ' a - g r i
vinagreiro|v i~ - n a - g r ' e j - r u
vinagreta|v i~ - n a - g r ' e - t a
vinagrete|v i~ - n a - g r ' E - tS i
vinário|v i~ - n ' a - r j u
vincada|v i~ - k ' a - d a
vincadamente|v i~ - k a - d a~ - m ' e~ - tS i
vincado|v i~ - k ' a - d u
vincar|v i~ - k ' a r
vincendo|v i~ - s ' e~ - d u
vinco|v ' i~ - k u
vinculação|v i~ - k u - l a - s ' a~ w
vinculadamente|v i~ - k u - l a - d a~ - m ' e~ - tS i
vinculado|v i~ - k u - l ' a - d u
vincular|v i~ - k u - l ' a r
vinculativo|v i~ - k u - l a - tS ' i - v u
vínculo|v ' i~ - k u - l u
vinda|v ' i~ - d a
vindicativamente|v i~ - dZ i - k a - tS i - v a~ - m ' e~ - tS i
vindicativo|v i~ - dZ i - k a - tS ' i - v u
vindicta|v i~ - dZ ' i - k ə - t a
vindima|v i~ - dZ ' i~ - m a
vindimado|v i~ - dZ i~ - m ' a - d u
vindimador|v i~ - dZ i~ - m a - d ' o r
vindimador|v i~ - dZ i~ - m a - d ' o r
vindimar|v i~ - dZ i~ - m ' a r
vindimo|v i~ - dZ ' i~ - m u
vindo|v ' i~ - d u
vindoura|v i~ - d ' o - r a
vindouro|v i~ - d ' o - r u
vinga|v ' i~ - g a
vingador|v i~ - g a - d ' o r
vingadora|v i~ - g a - d ' o - r a
vingança|v i~ - g ' a~ - s a
vingar|v i~ - g ' a r
vingativamente|v i~ - g a - tS i - v a~ - m ' e~ - tS i
vingativo|v i~ - g a - tS ' i - v u
vingue|v ' i~ - g i
vinha|v ' i~ - J a
vinhaça|v i~ - J ' a - s a
vinhal|v i~ - J ' a w
vinhão|v i~ - J ' a~ w
vinhateiro|v i~ - J a - t ' e j - r u
vinhateiro|v i~ - J a - t ' e j - r u
vinhático|v i~ - J ' a - tS i - k u
vinhedo|v i~ - J ' e - d u
vinheta|v i~ - J ' e - t a
vinho|v ' i~ - J u
vínico|v ' i~ - n i - k u
vinícola|v i~ - n ' i - k o - l a
vinicultor|v i~ - n i - k u w - t ' o r
vinicultura|v i~ - n i - k u w - t ' u - r a
vinificação|v i~ - n i - f i - k a - s ' a~ w
vinificador|v i~ - n i - f i - k a - d ' o r
vinificar|v i~ - n i - f i - k ' a r
vinil|v i~ - n ' i w
vinílico|v i~ - n ' i - l i - k u
vinilo|v i~ - n ' i - l u
vinosidade|v i~ - n o - z i - d ' a - dZ i
vinoso|v i~ - n ' o - z u
vinte|v ' i~ - tS i
vinte|v ' i~ - tS i
vintém|v i~ - t ' e~ j
vintena|v i~ - t ' e~ - n a
vinténio|v i~ - t ' e~ - n j u
vinteno|v i~ - t ' e~ - n u
vintismo|v i~ - tS ' i Z - m u
vintista|v i~ - tS ' i S - t a
viola|v j ' O - l a
violação|v j o - l a - s ' a~ w
violácea|v j o - l ' a - s j a
violáceo|v j o - l ' a - s j u
violado|v j o - l ' a - d u
violador|v j o - l a - d ' o r
violadora|v j o - l a - d ' o - r a
violão|v j o - l ' a~ w
violar|v j o - l ' a r
violaria|v j o - l a - r ' i - a
violável|v j o - l ' a - v e w
violeiro|v j o - l ' e j - r u
violência|v j o - l ' e~ - s j a
violentado|v j o - l e~ - t ' a - d u
violentador|v j o - l e~ - t a - d ' o r
violentadora|v j o - l e~ - t a - d ' o - r a
violentamente|v j o - l e~ - t a~ - m ' e~ - tS i
violentar|v j o - l e~ - t ' a r
violento|v j o - l ' e~ - t u
violeta|v j o - l ' e - t a
violinista|v j o - l i~ - n ' i S - t a
violinístico|v j o - l i~ - n ' i S - tS i - k u
violino|v j o - l ' i~ - n u
violista|v j o - l ' i S - t a
violista|v j o - l ' i S - t a
violoncelista|v j o - l o~ - s e - l ' i S - t a
violoncelo|v j o - l o~ - s ' E - l u
violonista|v j o - l o~ - n ' i S - t a
viperina|v i - p e - r ' i~ - n a
viperinamente|v i - p e - r i~ - n a~ - m ' e~ - tS i
viperino|v i - p e - r ' i~ - n u
viquingue|v i - k ' i~ - g i
vir|v ' i r
vira|v ' i - r a
viracasaca|v ˌ i - r a - k a - z ' a - k a
viracasaca|v ˌ i - r a - k a - z ' a - k a
viracasacas|v ˌ i - r a - k a - z ' a - k a S
viralata|v ˌ i - r a - l ' a - t a
viração|v i - r a - s ' a~ w
virada|v i - r ' a - d a
viradeira|v i - r a - d ' e j - r a
virado|v i - r ' a - d u
virago|v i - r ' a - g u
viral|v i - r ' a w
virar|v i - r ' a r
viravolta|v i - r a - v ' O w - t a
viravoltar|v i - r a - v o w - t ' a r
virgem|v ' i R - Z e~ j
virgem|v ' i R - Z e~ j
virginal|v i R - Z i~ - n ' a w
virginalmente|v i R - Z i~ - n a w - m ' e~ - tS i
virgindade|v i R - Z i~ - d ' a - dZ i
virgínia|v i R - Z ' i~ - n j a
virgo|v ' i R - g u
vírgula|v ' i R - g u - l a
virgular|v i R - g u - l ' a r
viriato|v i - r i - ' a - t u
viricida|v i - r i - s ' i - d a
viril|v i - r ' i w
virilha|v i - r ' i - L a
virilidade|v i - r i - l i - d ' a - dZ i
virilmente|v i - r i w - m ' e~ - tS i
viro|v ' i - r u
virola|v i - r ' O - l a
virologia|v i - r o - l o - Z ' i - a
virológico|v i - r o - l ' O - Z i - k u
virologista|v i - r o - l o - Z ' i S - t a
virose|v i - r ' O - z i
virote|v i - r ' O - tS i
virtual|v i r - t u - ' a w
virtualidade|v i r - t u - a - l i - d ' a - dZ i
virtualmente|v i r - t u - a w - m ' e~ - tS i
virtude|v i r - t ' u - dZ i
virtuosa|v i r - t w ' O - z a
virtuosamente|v i r - t w O - z a~ - m ' e~ - tS i
virtuosidade|v i r - t w o - z i - d ' a - dZ i
virtuosismo|v i r - t w o - z ' i Z - m u
virtuosístico|v i r - t w o - z ' i S - tS i - k u
virtuoso|v i r - t w ' o - z u
virulência|v i - r u - l ' e~ - s j a
virulentamente|v i - r u - l e~ - t a~ - m ' e~ - tS i
virulento|v i - r u - l ' e~ - t u
vírus|v ' i - r u S
visada|v i - z ' a - d a
visado|v i - z ' a - d u
visar|v i - z ' a r
víscera|v ' i - s e - r a
visceral|v i - s e - r ' a w
visceralidade|v i - s e - r a - l i - d ' a - dZ i
visceralmente|v i - s e - r a w - m ' e~ - tS i
visco|v ' i S - k u
visconde|v i S - k ' o~ - dZ i
viscondessa|v i S - k o~ - d ' e - s a
viscose|v i S - k ' O - z i
viscosidade|v i S - k o - z i - d ' a - dZ i
viscoso|v i S - k ' o - z u
viseense|v i - z e - ' e~ - s i
viseira|v i - z ' e j - r a
visgar|v i Z - g ' a r
visgo|v ' i Z - g u
visibilidade|v i - z i - b i - l i - d ' a - dZ i
visigodo|v i - z i - g ' o - d u
visigótico|v i - z i - g ' O - tS i - k u
visionamento|v i - z j o~ - n a~ - m ' e~ - t u
visionar|v i - z j o~ - n ' a r
visionária|v i - z j o~ - n ' a - r j a
visionariamente|v i - z j o~ - n a - r i - a~ - m ' e~ - tS i
visionário|v i - z j o~ - n ' a - r j u
visionarismo|v i - z j o~ - n a - r ' i Z - m u
visita|v i - z ' i - t a
visitarelâmpago|v i - z ˌ i - t a - R e - l ' a~ - p a - g u
visitação|v i - z i - t a - s ' a~ w
visitador|v i - z i - t a - d ' o r
visitadora|v i - z i - t a - d ' o - r a
visitante|v i - z i - t ' a~ - tS i
visitante|v i - z i - t ' a~ - tS i
visitar|v i - z i - t ' a r
visitável|v i - z i - t ' a - v e w
visível|v i - z ' i - v e w
visivelmente|v i - z i - v E w - m ' e~ - tS i
vislumbrar|v i Z - l u~ - b r ' a r
vislumbre|v i Z - l ' u~ - b r i
viso|v ' i - z u
visom|v i - z ' o~
visor|v i - z ' o r
vista|v ' i S - t a
visto|v ' i S - t u
vistoria|v i S - t o - r ' i - a
vistoriar|v i S - t o - r i - ' a r
vistosamente|v i S - t O - z a~ - m ' e~ - tS i
vistoso|v i S - t ' o - z u
visual|v i - z u - ' a w
visual|v i - z u - ' a w
visualidade|v i - z u - a - l i - d ' a - dZ i
visualização|v i - z u - a - l i - z a - s ' a~ w
visualizar|v i - z u - a - l i - z ' a r
visualmente|v i - z u - a w - m ' e~ - tS i
vital|v i - t ' a w
vitaliciamente|v i - t a - l i - s i - a~ - m ' e~ - tS i
vitalício|v i - t a - l ' i - s j u
vitalidade|v i - t a - l i - d ' a - dZ i
vitalismo|v i - t a - l ' i Z - m u
vitalista|v i - t a - l ' i S - t a
vitalização|v i - t a - l i - z a - s ' a~ w
vitalizado|v i - t a - l i - z ' a - d u
vitalizar|v i - t a - l i - z ' a r
vitalmente|v i - t a w - m ' e~ - tS i
vitamina|v i - t a~ - m ' i~ - n a
vitaminado|v i - t a~ - m i~ - n ' a - d u
vitaminar|v i - t a~ - m i~ - n ' a r
vitamínico|v i - t a~ - m ' i~ - n i - k u
vitela|v i - t ' E - l a
vitelo|v i - t ' E - l u
vitícola|v i - tS ' i - k o - l a
viticultor|v i - tS i - k u w - t ' o r
viticultura|v i - tS i - k u w - t ' u - r a
vitiligo|v i - tS i - l ' i - g u
vítima|v ' i - tS i~ - m a
vitimar|v i - tS i~ - m ' a r
vitimização|v i - tS i~ - m i - z a - s ' a~ w
vitimizar|v i - tS i~ - m i - z ' a r
vitivinícola|v i - tS i - v i~ - n ' i - k o - l a
vitivinicultor|v i - tS i - v i~ - n i - k u w - t ' o r
vitivinicultura|v i - tS i - v i~ - n i - k u w - t ' u - r a
vitória|v i - t ' O - r j a
vitoriana|v i - t o - r i - ' a~ - n a
vitoriano|v i - t o - r i - ' a~ - n u
vitoriar|v i - t o - r i - ' a r
vitoriosa|v i - t o - r j ' O - z a
vitoriosamente|v i - t o - r j o - z a~ - m ' e~ - tS i
vitorioso|v i - t o - r j ' o - z u
vitral|v i - t r ' a w
vítreo|v ' i - t r j u
vitrificar|v i - t r i - f i - k ' a r
vitrina|v i - t r ' i~ - n a
vitrine|v i - t r ' i~ - n i
vitrinista|v i - t r i~ - n ' i S - t a
vitríolo|v i - t r ' i - o - l u
vitualha|v i - t u - ' a - L a
vitualhar|v i - t u - a - L ' a r
vitualhas|v i - t u - ' a - L a S
vituperar|v i - t u - p e - r ' a r
vitupério|v i - t u - p ' E - r j u
viúva|v i - ' u - v a
viuvar|v i - u - v ' a r
viuvez|v i - u - v ' e S
viuvinha|v i - u - v ' i~ - J a
viúvo|v i - ' u - v u
viva|v ' i - v a
vivaça|v i - v ' a - s a
vivacidade|v i - v a - s i - d ' a - dZ i
vivaço|v i - v ' a - s u
vivalma|v i - v ' a w - m a
vivamente|v i - v a~ - m ' e~ - tS i
vivar|v i - v ' a r
vivaz|v i - v ' a S
vivazmente|v i - v a Z - m ' e~ - tS i
viveiro|v i - v ' e j - r u
vivência|v i - v ' e~ - s j a
vivencial|v i - v e~ - s i - ' a w
vivenciar|v i - v e~ - s i - ' a r
vivenda|v i - v ' e~ - d a
vivente|v i - v ' e~ - tS i
viver|v i - v ' e r
víveres|v ' i - v e - r i S
viveza|v i - v ' e - z a
vividamente|v i - v i - d a~ - m ' e~ - tS i
vívido|v ' i - v i - d u
vivido|v i - v ' i - d u
vivificação|v i - v i - f i - k a - s ' a~ w
vivificador|v i - v i - f i - k a - d ' o r
vivificadora|v i - v i - f i - k a - d ' o - r a
vivificante|v i - v i - f i - k ' a~ - tS i
vivificantemente|v i - v i - f i - k a~ - t e~ - m ' e~ - tS i
vivificar|v i - v i - f i - k ' a r
vivissecção|v i - v i - s e - k ə - s ' a~ w
vivo|v ' i - v u
vizelense|v i - z e - l ' e~ - s i
vizinha|v i - z ' i~ - J a
vizinhança|v i - z i~ - J ' a~ - s a
vizinhar|v i - z i~ - J ' a r
vizinho|v i - z ' i~ - J u
vizir|v i - z ' i r
voador|v o - a - d ' o r
voadora|v o - a - d ' o - r a
voar|v o - ' a r
voaria|v o - a - r ' i - a
vocabular|v o - k a - b u - l ' a r
vocabulário|v o - k a - b u - l ' a - r j u
vocábulo|v o - k ' a - b u - l u
vocação|v o - k a - s ' a~ w
vocacionado|v o - k a - s j o~ - n ' a - d u
vocacional|v o - k a - s j o~ - n ' a w
vocacionar|v o - k a - s j o~ - n ' a r
vocal|v o - k ' a w
vocalicamente|v o - k a - l i - k a~ - m ' e~ - tS i
vocálico|v o - k ' a - l i - k u
vocalista|v o - k a - l ' i S - t a
vocalização|v o - k a - l i - z a - s ' a~ w
vocalizar|v o - k a - l i - z ' a r
vocalizo|v o - k a - l ' i - z u
vocalmente|v o - k a w - m ' e~ - tS i
vocativamente|v o - k a - tS i - v a~ - m ' e~ - tS i
vocativo|v o - k a - tS ' i - v u
você|v o - s ' e
vociferação|v o - s i - f e - r a - s ' a~ w
vociferante|v o - s i - f e - r ' a~ - tS i
vociferar|v o - s i - f e - r ' a r
voga|v ' O - g a
vogal|v o - g ' a w
vogar|v o - g ' a r
volante|v o - l ' a~ - tS i
volapuque|v O - l a - p ' u - k i
volátil|v o - l ' a - tS i w
volatilidade|v o - l a - tS i - l i - d ' a - dZ i
volatilização|v o - l a - tS i - l i - z a - s ' a~ w
volatilizar|v o - l a - tS i - l i - z ' a r
vólei|v ' O - l e j
voleibol|v o - l e j - b ' O w
voleibolista|v o - l e j - b o - l ' i S - t a
volfrâmio|v o w - f r ' a~ - m j u
volframite|v o w - f r a~ - m ' i - tS i
volição|v o - l i - s ' a~ w
volitivo|v o - l i - tS ' i - v u
volo|v ' O - l u
volta|v ' O w - t a
voltagem|v o w - t ' a - Z e~ j
voltaico|v o w - t ' a j - k u
voltairiano|v o w - t E - r i - ' a~ - n u
voltar|v o w - t ' a r
volte|v ' O w - tS i
volteface|v ˌ o w - tS i - f ' a - s i
voltear|v o w - tS i - ' a r
volteio|v o w - t ' e j - u
voltejar|v o w - t e - Z ' a r
voltímetro|v o w - tS ' i~ - m e - t r u
vóltio|v ' O w - tS j u
volubilidade|v o - l u - b i - l i - d ' a - dZ i
volumar|v o - l u~ - m ' a r
volume|v o - l ' u~ - m i
volumetria|v o - l u~ - m e - t r ' i - a
volumetricamente|v o - l u~ - m E - t r i - k a~ - m ' e~ - tS i
volumétrico|v o - l u~ - m ' E - t r i - k u
volúmico|v o - l ' u~ - m i - k u
volumosamente|v o - l u~ - m O - z a~ - m ' e~ - tS i
volumoso|v o - l u~ - m ' o - z u
voluntária|v o - l u~ - t ' a - r j a
voluntariado|v o - l u~ - t a - r i - ' a - d u
voluntariamente|v o - l u~ - t a - r i - a~ - m ' e~ - tS i
voluntariar|v o - l u~ - t a - r i - ' a r
voluntariedade|v o - l u~ - t a - r j e - d ' a - dZ i
voluntário|v o - l u~ - t ' a - r j u
voluntariosa|v o - l u~ - t a - r j ' O - z a
voluntariosamente|v o - l u~ - t a - r j O - z a~ - m ' e~ - tS i
voluntarioso|v o - l u~ - t a - r j ' o - z u
voluntarioso|v o - l u~ - t a - r j ' o - z u
voluntarismo|v o - l u~ - t a - r ' i Z - m u
voluntarista|v o - l u~ - t a - r ' i S - t a
volúpia|v o - l ' u - p j a
voluptuosa|v o - l u p - t w ' O - z a
voluptuosamente|v o - l u p - t w o - z a~ - m ' e~ - tS i
voluptuosidade|v o - l u p - t w o - z i - d ' a - dZ i
voluptuoso|v o - l u p - t w ' o - z u
voluta|v o - l ' u - t a
volutar|v o - l u - t ' a r
volúvel|v o - l ' u - v e w
voluvelmente|v o - l u - v e w - m ' e~ - tS i
volva|v ' o w - v a
volver|v o w - v ' e r
volvido|v o w - v ' i - d u
volvo|v ' o w - v u
vomitado|v o~ - m i - t ' a - d u
vomitado|v o~ - m i - t ' a - d u
vomitar|v o~ - m i - t ' a r
vómito|v ' u~ - m i - t u
vomitório|v o~ - m i - t ' O - r j u
vontade|v o~ - t ' a - dZ i
voracidade|v o - r a - s i - d ' a - dZ i
voragem|v o - r ' a - Z e~ j
voraz|v o - r ' a S
vorazmente|v o - r a Z - m ' e~ - tS i
vórtice|v ' O r - tS i - s i
vos|v u S
vós|v ' O S
vossemecê|v O - s e~ - m e - s ' e
vosso|v ' O - s u
votação|v o - t a - s ' a~ w
votado|v o - t ' a - d u
votante|v o - t ' a~ - tS i
votante|v o - t ' a~ - tS i
votar|v o - t ' a r
votivamente|v o - tS i - v a~ - m ' e~ - tS i
votivo|v o - tS ' i - v u
voto|v ' O - t u
vouzelense|v o - z e - l ' e~ - s i
vovó|v O - v ' O
vovô|v o - v ' o
voyeurismo|v o j - a - r ' i Z - m u
voyeurista|v o j - a - r ' i S - t a
voz|v ' O S
vozoff|v ˌ O - z ' O f
vozear|v o - z i - ' a r
vozearia|v o - z e - a - r ' i - a
vozeirão|v o - z e j - r ' a~ w
vudu|v u - d ' u
vulcanicamente|v u w - k a~ - n i - k a~ - m ' e~ - tS i
vulcânico|v u w - k ' a~ - n i - k u
vulcanismo|v u w - k a~ - n ' i Z - m u
vulcanização|v u w - k a~ - n i - z a - s ' a~ w
vulcanizar|v u w - k a~ - n i - z ' a r
vulcanologia|v u w - k a~ - n o - l o - Z ' i - a
vulcanológico|v u w - k a~ - n o - l ' O - Z i - k u
vulcanólogo|v u w - k a~ - n ' O - l o - g u
vulcão|v u w - k ' a~ w
vulgar|v u w - g ' a r
vulgaridade|v u w - g a - r i - d ' a - dZ i
vulgarização|v u w - g a - r i - z a - s ' a~ w
vulgarizar|v u w - g a - r i - z ' a r
vulgarmente|v u w - g a R - m ' e~ - tS i
vulgo|v ' u w - g u
vulnerabilidade|v u w - n e - r a - b i - l i - d ' a - dZ i
vulnerabilizar|v u w - n e - r a - b i - l i - z ' a r
vulnerar|v u w - n e - r ' a r
vulnerável|v u w - n e - r ' a - v e w
vulneravelmente|v u w - n e - r a - v e w - m ' e~ - tS i
vulto|v ' u w - t u
vultosamente|v u w - t O - z a~ - m ' e~ - tS i
vultoso|v u w - t ' o - z u
vultuosamente|v u w - t w O - z a~ - m ' e~ - tS i
vultuoso|v u w - t w ' o - z u
vulva|v ' u w - v a
vulvar|v u w - v ' a r
vuvu|v u - v ' u
wagneriana|v a - g i~ - n e - r i - ' a~ - n a
wagneriano|v a - g i~ - n e - r i - ' a~ - n u
washingtoniano|w o - S i~ - g ə - t o~ - n i - ' a~ - n u
weberiano|w E - b e - r i - ' a~ - n u
wilsoniano|w i w - s o~ - n i - ' a~ - n u
windsurfista|w i~ n d - s u r - f ' i S - t a
xá|S ' a
xabrega|S a - b r ' E - g a
xabregas|S a - b r ' E - g a S
xácara|S ' a - k a - r a
xadrez|S a - d r ' e S
xaile|S ' a j - l i
xale|S ' a - l i
xamã|S a~ - m ' a~
xamane|S a~ - m ' a~ - n i
xamanismo|S a~ - m a~ - n ' i Z - m u
xamanístico|S a~ - m a~ - n ' i S - tS i - k u
xangaiense|S a~ - g a j - ' e~ - s i
xantina|S a~ - tS ' i~ - n a
xara|S ' a - r a
xarém|S a - r ' e~ j
xaropada|S a - r o - p ' a - d a
xaropar|S a - r o - p ' a r
xarope|S a - r ' O - p i
xaroposo|S a - r o - p ' o - z u
xávega|S ' a - v e - g a
xelim|S e - l ' i~
xenar|S e~ - n ' a r
xenofilia|S e~ - n o - f i - l ' i - a
xenófoba|S e~ - n ' O - f o - b a
xenofobia|S e~ - n o - f o - b ' i - a
xenofobismo|S e~ - n o - f o - b ' i Z - m u
xenófobo|S e~ - n ' O - f o - b u
xénon|S ' e~ - n o~
xenotransplante|S e~ - n o - t r a~ S - p l ' a~ - tS i
xepa|S ' e - p a
xeque|S ' E - k i
xequemate|S ˌ E - k i - m ' a - tS i
xerafim|S e - r a - f ' i~
xerez|S e - r ' e S
xerife|S e - r ' i - f i
xerodermia|S e - r o - d e R - m ' i - a
xerox|S e - r ' O k s
xerox|S e - r ' O k s
xícara|S ' i - k a - r a
xicuembo|S i - k w ' e~ - b u
xigubo|S i - g ' u - b u
xiismo|S i - ' i Z - m u
xiita|S i - ' i - t a
xila|S ' i - l a
xileno|S i - l ' e~ - n u
xilófago|S i - l ' O - f a - g u
xilofone|S i - l o - f ' u~ - n i
xilogravador|S i - l o - g r a - v a - d ' o r
xilogravura|S i - l o - g r a - v ' u - r a
xiluva|S i - l ' u - v a
xinga|S ' i~ - g a
xingar|S i~ - g ' a r
xintoísmo|S i~ - t w ' i Z - m u
xintoísta|S i~ - t w ' i S - t a
xipalapala|S i - p a - l a - p ' a - l a
xis|S ' i S
xistarca|S i S - t ' a r - k a
xisto|S ' i S - t u
xistoso|S i S - t ' o - z u
xiu|S ' i - u
xixi|S i - S ' i
xô|S ' o
xogum|S O - g ' u~
xonar|S u~ - n ' a r
xotar|S o - t ' a r
xote|S ' O - tS i
xote|S ' O - tS i
zabumba|z a - b ' u~ - b a
zabumbar|z a - b u~ - b ' a r
zaga|z ' a - g a
zagaia|z a - g ' a j - a
zagaiada|z a - g a j - ' a - d a
zagaiar|z a - g a j - ' a r
zagal|z a - g ' a w
zagalote|z a - g a - l ' O - tS i
zagueiro|z a - g ' e j - r u
zaida|z ' a j - d a
zaina|z ' a~ j - n a
zaino|z ' a~ j - n u
zaira|z ' a j - r a
zaire|z ' a j - r i
zairense|z a j - r ' e~ - s i
zamba|z ' a~ - b a
zambiana|z a~ - b i - ' a~ - n a
zambiano|z a~ - b i - ' a~ - n u
zambo|z ' a~ - b u
zambra|z ' a~ - b r a
zambro|z ' a~ - b r u
zambujal|z a~ - b u - Z ' a w
zambujeiro|z a~ - b u - Z ' e j - r u
zambujo|z a~ - b ' u - Z u
zampar|z a~ - p ' a r
zanga|z ' a~ - g a
zangado|z a~ - g ' a - d u
zangão|z a~ - g ' a~ w
zangar|z a~ - g ' a r
zanzibar|z a~ - z i - b ' a r
zaragata|z a - r a - g ' a - t a
zaragateira|z a - r a - g a - t ' e j - r a
zaragateiro|z a - r a - g a - t ' e j - r u
zaragatoa|z a - r a - g a - t ' o - a
zaragatoar|z a - r a - g a - t o - ' a r
zarcão|z a r - k ' a~ w
zarco|z ' a r - k u
zargo|z ' a R - g u
zarolho|z a - r ' o - L u
zarpar|z a r - p ' a r
zarro|z ' a - R u
zarzuela|z a R - z w ' E - l a
zás|z ' a S
zau|z ' a w
zavar|z a - v ' a r
zé|z ' E
zê|z ' e
zéninguém|z ˌ E - n i~ - g ' e~ j
zépereira|z ˌ E - p e - r ' e j - r a
zépovinho|z ˌ E - p o - v ' i~ - J u
zebra|z ' e - b r a
zebrar|z e - b r ' a r
zebro|z ' e - b r u
zebu|z ' e - b u
zéfiro|z ' E - f i - r u
zelador|z e - l a - d ' o r
zelar|z e - l ' a r
zelo|z ' e - l u
zelosamente|z e - l o - z a~ - m ' e~ - tS i
zeloso|z e - l ' o - z u
zenda|z ' e~ - d a
zende|z ' e~ - dZ i
zenir|z e~ - n ' i r
zenital|z e~ - n i - t ' a w
zénite|z ' e~ - n i - tS i
zepelim|z e - p e - l ' i~
zero|z ' E - r u
zeta|z ' E - t a
zeugma|z ' e w - g ə ̃ - m a
zibelina|z i - b e - l ' i~ - n a
zigoto|z i - g ' o - t u
ziguezague|z i - g e - z ' a - g i
ziguezagueante|z i - g e - z a - g i - ' a~ - tS i
ziguezaguear|z i - g e - z a - g i - ' a r
zigurate|z i - g u - r ' a - tS i
zimbabuano|z i~ - b a - b u - ' a~ - n u
zimbo|z ' i~ - b u
zimbório|z i~ - b ' O - r j u
zimbral|z i~ - b r ' a w
zimbrar|z i~ - b r ' a r
zimbro|z ' i~ - b r u
zina|z ' i~ - n a
zincar|z i~ - k ' a r
zinco|z ' i~ - k u
zincogravura|z i~ - k o - g r a - v ' u - r a
zinga|z ' i~ - g a
zingar|z i~ - g ' a r
zíngaro|z ' i~ - g a - r u
zinho|z ' i~ - J u
zinir|z i~ - n ' i r
zircónio|z i r - k ' u~ - n j u
zito|z ' i - t u
zoada|z o - ' a - d a
zoar|z o - ' a r
zodiacal|z o - dZ i - a - k ' a w
zoilo|z ' o j - l u
zola|z ' O - l a
zomba|z ' o~ - b a
zombar|z o~ - b ' a r
zombaria|z o~ - b a - r ' i - a
zombeteira|z o~ - b e - t ' e j - r a
zombeteiramente|z o~ - b e - t e j - r a~ - m ' e~ - tS i
zombeteiro|z o~ - b e - t ' e j - r u
zona|z ' o~ - n a
zonal|z o~ - n ' a w
zonamento|z o~ - n a~ - m ' e~ - t u
zonar|z o~ - n ' a r
zoneamento|z o~ - n e - a~ - m ' e~ - t u
zongola|z o~ - g ' o - l a
zongolar|z o~ - g o - l ' a r
zonzo|z ' o~ - z u
zonzom|z o~ - z ' o~
zoo|z ' o - u
zoófila|z o - ' O - f i - l a
zoófilo|z o - ' O - f i - l u
zoófilo|z o - ' O - f i - l u
zoologia|z o - l o - Z ' i - a
zoologicamente|z o - l O - Z i - k a~ - m ' e~ - tS i
zoológico|z o - l ' O - Z i - k u
zoólogo|z o - ' O - l o - g u
zoomórfico|z o - o~ - m ' O r - f i - k u
zoonose|z o - o~ - n ' O - z i
zooplâncton|z o - o - p l ' a~ ŋ k - t o~
zootecnia|z o - o - t E - k i~ - n ' i - a
zootécnica|z o - o - t ' E - k i~ - n i - k a
zootécnico|z o - o - t ' E - k i~ - n i - k u
zopo|z ' o - p u
zoroastriano|z o - r o - a S - t r i - ' a~ - n u
zoroastrismo|z o - r o - a S - t r ' i Z - m u
zoroastrista|z o - r o - a S - t r ' i S - t a
zoroastrista|z o - r o - a S - t r ' i S - t a
zorra|z ' o - R a
zorro|z ' o - R u
zuavo|z u - ' a - v u
zuca|z ' u - k a
zucar|z u - k ' a r
zuco|z ' u - k u
zuir|z w ' i r
zular|z u - l ' a r
zulo|z ' u - l u
zumba|z ' u~ - b a
zumbar|z u~ - b ' a r
zumbi|z u~ - b ' i
zumbido|z u~ - b ' i - d u
zumbir|z u~ - b ' i r
zunido|z u~ - n ' i - d u
zunir|z u~ - n ' i r
zunzum|z u~ - z ' u~
zurrapa|z u - R ' a - p a
zurrar|z u - R ' a r
zurzidela|z u R - z i - d ' E - l a
zurzir|z u R - z ' i r